Lblproject'Coln'Discriminant	Lblproject'Coln'Discriminant.yaml
LblisTraitSpecializationKind	LblisTraitSpecializationKind.yaml
Lblproject'Coln'MaybeLayoutShape	Lblproject'Coln'MaybeLayoutShape.yaml
Lblproject'Coln'MirConst	Lblproject'Coln'MirConst.yaml
LblisRefType'LParUndsRParUnds'KMIR-CONTROL-FLOW'Unds'Bool'Unds'TypeInfo	LblisRefType'LParUndsRParUnds'KMIR-CONTROL-FLOW'Unds'Bool'Unds'TypeInfo.yaml
Lblproject'Coln'AssertMessage'ColnColn'MisalignedPointerDereference'Coln'found	Lblproject'Coln'AssertMessage'ColnColn'MisalignedPointerDereference'Coln'found.yaml
Lblproject'Coln'TerminatorKind'ColnColn'Call'Coln'args	Lblproject'Coln'TerminatorKind'ColnColn'Call'Coln'args.yaml
Lblproject'Coln'BoundTy	Lblproject'Coln'BoundTy.yaml
Lblproject'Coln'fnSig'LParUndsCommUndsCommUndsCommUndsRParUnds'TYPES'Unds'FnSig'Unds'Tys'Unds'MIRBool'Unds'Safety'Unds'Abi'Coln'unsafety	Lblproject'Coln'fnSig'LParUndsCommUndsCommUndsCommUndsRParUnds'TYPES'Unds'FnSig'Unds'Tys'Unds'MIRBool'Unds'Safety'Unds'Abi'Coln'unsafety.yaml
LblisCallerCell	LblisCallerCell.yaml
Lblproject'Coln'VariantsShapeSingle	Lblproject'Coln'VariantsShapeSingle.yaml
Lblproject'Coln'PassMode	Lblproject'Coln'PassMode.yaml
Lblproject'Coln'coercePredicate'LParUndsCommUndsRParUnds'TYPES'Unds'CoercePredicate'Unds'Ty'Unds'Ty'Coln'a	Lblproject'Coln'coercePredicate'LParUndsCommUndsRParUnds'TYPES'Unds'CoercePredicate'Unds'Ty'Unds'Ty'Coln'a.yaml
Lblproject'Coln'Movability	Lblproject'Coln'Movability.yaml
LblisMaybeGenericDef	LblisMaybeGenericDef.yaml
Lbl'Hash'updateStackLocal'LParUndsCommUndsCommUndsRParUnds'RT-DATA'Unds'StackFrame'Unds'StackFrame'Unds'Int'Unds'Value	Lbl'Hash'updateStackLocal'LParUndsCommUndsCommUndsRParUnds'RT-DATA'Unds'StackFrame'Unds'StackFrame'Unds'Int'Unds'Value.yaml
LblnotBool'Unds'	LblnotBool'Unds'.yaml
Lbl'UndsPerc'Int'Unds'	Lbl'UndsPerc'Int'Unds'.yaml
Lbl'Unds-GT-Eqls'String'UndsUnds'STRING-COMMON'Unds'Bool'Unds'String'Unds'String	Lbl'Unds-GT-Eqls'String'UndsUnds'STRING-COMMON'Unds'Bool'Unds'String'Unds'String.yaml
Lblproject'Coln'coercePredicate'LParUndsCommUndsRParUnds'TYPES'Unds'CoercePredicate'Unds'Ty'Unds'Ty'Coln'b	Lblproject'Coln'coercePredicate'LParUndsCommUndsRParUnds'TYPES'Unds'CoercePredicate'Unds'Ty'Unds'Ty'Coln'b.yaml
Lbl'Stop'List	Lbl'Stop'List.yaml
LblisFieldsShapeArbitrary	LblisFieldsShapeArbitrary.yaml
LblisIntegerLength	LblisIntegerLength.yaml
Lblproject'Coln'Abi'ColnColn'Fastcall'Coln'unwind	Lblproject'Coln'Abi'ColnColn'Fastcall'Coln'unwind.yaml
LblceilFloat'LParUndsRParUnds'FLOAT'Unds'Float'Unds'Float	LblceilFloat'LParUndsRParUnds'FLOAT'Unds'Float'Unds'Float.yaml
Lblproject'Coln'Statement	Lblproject'Coln'Statement.yaml
LblisUnevaluatedConst	LblisUnevaluatedConst.yaml
Lblproject'Coln'MaybeBasicBlockIdx	Lblproject'Coln'MaybeBasicBlockIdx.yaml
LblisTyConstId	LblisTyConstId.yaml
Lblproject'Coln'ProjectionElems	Lblproject'Coln'ProjectionElems.yaml
LbllookupAlloc2	LbllookupAlloc2.yaml
Lbl'Hash'littleEndianBytesFromInt'LParUndsCommUndsRParUnds'RT-DATA'Unds'List'Unds'Int'Unds'Int	Lbl'Hash'littleEndianBytesFromInt'LParUndsCommUndsRParUnds'RT-DATA'Unds'List'Unds'Int'Unds'Int.yaml
LblisClosureDef	LblisClosureDef.yaml
LblisGeneratedTopCellFragment	LblisGeneratedTopCellFragment.yaml
LblisKmirCellFragment	LblisKmirCellFragment.yaml
Lblproject'Coln'MonoItems	Lblproject'Coln'MonoItems.yaml
LblisFieldDef	LblisFieldDef.yaml
Lblproject'Coln'Place	Lblproject'Coln'Place.yaml
Lblproject'Coln'boundTy'LParUndsCommUndsRParUnds'TYPES'Unds'BoundTy'Unds'MIRInt'Unds'BoundTyKind'Coln'var	Lblproject'Coln'boundTy'LParUndsCommUndsRParUnds'TYPES'Unds'BoundTy'Unds'MIRInt'Unds'BoundTyKind'Coln'var.yaml
Lblproject'Coln'DestCell	Lblproject'Coln'DestCell.yaml
Lblproject'Coln'VarDebugInfo	Lblproject'Coln'VarDebugInfo.yaml
Lbl'Hash'zeroSizedType'LParUndsRParUnds'RT-TYPES'Unds'Bool'Unds'TypeInfo	Lbl'Hash'zeroSizedType'LParUndsRParUnds'RT-TYPES'Unds'Bool'Unds'TypeInfo.yaml
Lblproject'Coln'ConstantKind	Lblproject'Coln'ConstantKind.yaml
Lblproject'Coln'MaybePromoted	Lblproject'Coln'MaybePromoted.yaml
Lblproject'Coln'wrappingRange'LParUndsCommUndsRParUnds'TYPES'Unds'WrappingRange'Unds'MIRInt'Unds'MIRInt'Coln'start	Lblproject'Coln'wrappingRange'LParUndsCommUndsRParUnds'TYPES'Unds'WrappingRange'Unds'MIRInt'Unds'MIRInt'Coln'start.yaml
LblisWriteTo	LblisWriteTo.yaml
Lblproject'Coln'TerminatorKind'ColnColn'Call'Coln'target	Lblproject'Coln'TerminatorKind'ColnColn'Call'Coln'target.yaml
LblFloat2String'LParUndsRParUnds'STRING-COMMON'Unds'String'Unds'Float	LblFloat2String'LParUndsRParUnds'STRING-COMMON'Unds'String'Unds'Float.yaml
Lblproject'Coln'GenericParamDefKind'ColnColn'Const'Coln'hasDefault	Lblproject'Coln'GenericParamDefKind'ColnColn'Const'Coln'hasDefault.yaml
LblupdateMap'LParUndsCommUndsRParUnds'MAP'Unds'Map'Unds'Map'Unds'Map	LblupdateMap'LParUndsCommUndsRParUnds'MAP'Unds'Map'Unds'Map'Unds'Map.yaml
LblisParamDef	LblisParamDef.yaml
Lblproject'Coln'TestSort2	Lblproject'Coln'TestSort2.yaml
Lblproject'Coln'IntegerLength	Lblproject'Coln'IntegerLength.yaml
Lblproject'Coln'Opaque	Lblproject'Coln'Opaque.yaml
LblisVariantDef	LblisVariantDef.yaml
LblinitCallerCell	LblinitCallerCell.yaml
Lblproject'Coln'FnSig	Lblproject'Coln'FnSig.yaml
Lblproject'Coln'MaybeBinderForExistentialTraitRef	Lblproject'Coln'MaybeBinderForExistentialTraitRef.yaml
Lblproject'Coln'genericParamDef'LParUndsCommUndsCommUndsCommUndsCommUndsRParUnds'TYPES'Unds'GenericParamDef'Unds'Symbol'Unds'GenericDef'Unds'MIRInt'Unds'MIRBool'Unds'GenericParamDefKind'Coln'name	Lblproject'Coln'genericParamDef'LParUndsCommUndsCommUndsCommUndsCommUndsRParUnds'TYPES'Unds'GenericParamDef'Unds'Symbol'Unds'GenericDef'Unds'MIRInt'Unds'MIRBool'Unds'GenericParamDefKind'Coln'name.yaml
Lblproject'Coln'KCell	Lblproject'Coln'KCell.yaml
Lbl'Hash'isArrayType'LParUndsRParUnds'RT-TYPES'Unds'Bool'Unds'TypeInfo	Lbl'Hash'isArrayType'LParUndsRParUnds'RT-TYPES'Unds'Bool'Unds'TypeInfo.yaml
LblisKCell	LblisKCell.yaml
Lblproject'Coln'TerminatorKind'ColnColn'SwitchInt'Coln'targets	Lblproject'Coln'TerminatorKind'ColnColn'SwitchInt'Coln'targets.yaml
LblisMaybeSpan	LblisMaybeSpan.yaml
Lblproject'Coln'Abi'ColnColn'System'Coln'unwind	Lblproject'Coln'Abi'ColnColn'System'Coln'unwind.yaml
LblisKCellOpt	LblisKCellOpt.yaml
Lblproject'Coln'argAbi'LParUndsCommUndsCommUndsRParUnds'ABI'Unds'ArgAbi'Unds'Ty'Unds'Layout'Unds'PassMode'Coln'mode	Lblproject'Coln'argAbi'LParUndsCommUndsCommUndsRParUnds'ABI'Unds'ArgAbi'Unds'Ty'Unds'Layout'Unds'PassMode'Coln'mode.yaml
LblisForeignDef	LblisForeignDef.yaml
Lblproject'Coln'FieldDef	Lblproject'Coln'FieldDef.yaml
Lblproject'Coln'inlineAsmOperand'LParUndsCommUndsCommUndsRParUnds'BODY'Unds'InlineAsmOperand'Unds'MaybeOperand'Unds'MaybePlace'Unds'MIRString'Coln'outValue	Lblproject'Coln'inlineAsmOperand'LParUndsCommUndsCommUndsRParUnds'BODY'Unds'InlineAsmOperand'Unds'MaybeOperand'Unds'MaybePlace'Unds'MIRString'Coln'outValue.yaml
Lbl'UndsEqlsEqls'Float'Unds'	Lbl'UndsEqlsEqls'Float'Unds'.yaml
LblisLocalsCell	LblisLocalsCell.yaml
LbllookupAlloc0	LbllookupAlloc0.yaml
Lblproject'Coln'allocation'Coln'bytes	Lblproject'Coln'allocation'Coln'bytes.yaml
LblisMap	LblisMap.yaml
Lblproject'Coln'earlyParamRegion'LParUndsCommUndsRParUnds'TYPES'Unds'EarlyParamRegion'Unds'MIRInt'Unds'Symbol'Coln'name	Lblproject'Coln'earlyParamRegion'LParUndsCommUndsRParUnds'TYPES'Unds'EarlyParamRegion'Unds'MIRInt'Unds'Symbol'Coln'name.yaml
Lblproject'Coln'unevaluatedConst'LParUndsCommUndsCommUndsRParUnds'TYPES'Unds'UnevaluatedConst'Unds'ConstDef'Unds'GenericArgs'Unds'MaybePromoted'Coln'args	Lblproject'Coln'unevaluatedConst'LParUndsCommUndsCommUndsRParUnds'TYPES'Unds'UnevaluatedConst'Unds'ConstDef'Unds'GenericArgs'Unds'MaybePromoted'Coln'args.yaml
Lbl'UndsEqlsEqls'K'Unds'	Lbl'UndsEqlsEqls'K'Unds'.yaml
Lblproject'Coln'TypeInfo'ColnColn'StructType'Coln'fields	Lblproject'Coln'TypeInfo'ColnColn'StructType'Coln'fields.yaml
Lblproject'Coln'Float	Lblproject'Coln'Float.yaml
Lblproject'Coln'typeAndMut'LParUndsCommUndsRParUnds'TYPES'Unds'TypeAndMut'Unds'Ty'Unds'Mutability'Coln'ty	Lblproject'Coln'typeAndMut'LParUndsCommUndsRParUnds'TYPES'Unds'TypeAndMut'Unds'Ty'Unds'Mutability'Coln'ty.yaml
Lbl'Hash'metadataSizeAux'LParUndsRParUnds'RT-TYPES'Unds'MetadataSize'Unds'TypeInfo	Lbl'Hash'metadataSizeAux'LParUndsRParUnds'RT-TYPES'Unds'MetadataSize'Unds'TypeInfo.yaml
LblisInitMaskMaterialized	LblisInitMaskMaterialized.yaml
Lblproject'Coln'LayoutShape	Lblproject'Coln'LayoutShape.yaml
Lblproject'Coln'InitMaskMaterialized	Lblproject'Coln'InitMaskMaterialized.yaml
LblisMaybeBasicBlockIdx	LblisMaybeBasicBlockIdx.yaml
Lblproject'Coln'instance'LParUndsCommUndsRParUnds'MONO'Unds'Instance'Unds'InstanceKind'Unds'InstanceDef'Coln'def	Lblproject'Coln'instance'LParUndsCommUndsRParUnds'MONO'Unds'Instance'Unds'InstanceKind'Unds'InstanceDef'Coln'def.yaml
LblsizeList	LblsizeList.yaml
Lblproject'Coln'LocalsCellOpt	Lblproject'Coln'LocalsCellOpt.yaml
Lblproject'Coln'TerminatorKind'ColnColn'SwitchInt'Coln'discr	Lblproject'Coln'TerminatorKind'ColnColn'SwitchInt'Coln'discr.yaml
Lblproject'Coln'CallerCellOpt	Lblproject'Coln'CallerCellOpt.yaml
LblisTyKind	LblisTyKind.yaml
Lbl'Unds-LT-Eqls'Set'UndsUnds'SET'Unds'Bool'Unds'Set'Unds'Set	Lbl'Unds-LT-Eqls'Set'UndsUnds'SET'Unds'Bool'Unds'Set'Unds'Set.yaml
Lblproject'Coln'MachineSize	Lblproject'Coln'MachineSize.yaml
LblisBoundVariableKind	LblisBoundVariableKind.yaml
Lblproject'Coln'TyAndLayout	Lblproject'Coln'TyAndLayout.yaml
LblisNullOp	LblisNullOp.yaml
Lblproject'Coln'VariantAndFieldIndices	Lblproject'Coln'VariantAndFieldIndices.yaml
Lblproject'Coln'mk'LParUndsCommUndsRParUnds'TYPES'Unds'PrimitiveInt'Unds'IntegerLength'Unds'MIRBool'Coln'signed	Lblproject'Coln'mk'LParUndsCommUndsRParUnds'TYPES'Unds'PrimitiveInt'Unds'IntegerLength'Unds'MIRBool'Coln'signed.yaml
Lbl'UndsLSqBUndsRSqBUnds'BYTES-HOOKED'Unds'Int'Unds'Bytes'Unds'Int	Lbl'UndsLSqBUndsRSqBUnds'BYTES-HOOKED'Unds'Int'Unds'Bytes'Unds'Int.yaml
LblinitRetValCell	LblinitRetValCell.yaml
Lblproject'Coln'MirConstId	Lblproject'Coln'MirConstId.yaml
Lblproject'Coln'TyConstKind	Lblproject'Coln'TyConstKind.yaml
LblisDiscriminants	LblisDiscriminants.yaml
Lblproject'Coln'BorrowKind'ColnColn'Mut'Coln'kind	Lblproject'Coln'BorrowKind'ColnColn'Mut'Coln'kind.yaml
LblisBitwise'LParUndsRParUnds'RT-DATA'Unds'Bool'Unds'BinOp	LblisBitwise'LParUndsRParUnds'RT-DATA'Unds'Bool'Unds'BinOp.yaml
Lbl'UndsPlus'Bytes'UndsUnds'BYTES-HOOKED'Unds'Bytes'Unds'Bytes'Unds'Bytes	Lbl'UndsPlus'Bytes'UndsUnds'BYTES-HOOKED'Unds'Bytes'Unds'Bytes'Unds'Bytes.yaml
Lblproject'Coln'RangeInclusiveForVariantIdx	Lblproject'Coln'RangeInclusiveForVariantIdx.yaml
Lblproject'Coln'Endian	Lblproject'Coln'Endian.yaml
LblisImplDef	LblisImplDef.yaml
Lblproject'Coln'VarDebugInfoContents	Lblproject'Coln'VarDebugInfoContents.yaml
Lblproject'Coln'traitDecl'LParUndsCommUndsCommUndsCommUndsCommUndsCommUndsCommUndsCommUndsCommUndsCommUndsCommUndsRParUnds'TYPES'Unds'TraitDecl'Unds'TraitDef'Unds'Safety'Unds'MIRBool'Unds'MIRBool'Unds'MIRBool'Unds'MIRBool'Unds'MIRBool'Unds'TraitSpecializationKind'Unds'MaybeIdents'Unds'MIRBool'Unds'MIRBool'Coln'specializationKind	Lblproject'Coln'traitDecl'LParUndsCommUndsCommUndsCommUndsCommUndsCommUndsCommUndsCommUndsCommUndsCommUndsCommUndsRParUnds'TYPES'Unds'TraitDecl'Unds'TraitDef'Unds'Safety'Unds'MIRBool'Unds'MIRBool'Unds'MIRBool'Unds'MIRBool'Unds'MIRBool'Unds'70.yaml
LblisBoundRegion	LblisBoundRegion.yaml
Lblproject'Coln'VariantsShapeMultiple	Lblproject'Coln'VariantsShapeMultiple.yaml
LblisVariantsShape	LblisVariantsShape.yaml
Lblproject'Coln'GeneratedCounterCell	Lblproject'Coln'GeneratedCounterCell.yaml
Lblproject'Coln'BasicBlocks	Lblproject'Coln'BasicBlocks.yaml
LblisMyList	LblisMyList.yaml
LblisScalar	LblisScalar.yaml
LblisMetadataSize	LblisMetadataSize.yaml
Lblproject'Coln'wrappingRange'LParUndsCommUndsRParUnds'TYPES'Unds'WrappingRange'Unds'MIRInt'Unds'MIRInt'Coln'end	Lblproject'Coln'wrappingRange'LParUndsCommUndsRParUnds'TYPES'Unds'WrappingRange'Unds'MIRInt'Unds'MIRInt'Coln'end.yaml
Lblproject'Coln'MachineInfo	Lblproject'Coln'MachineInfo.yaml
LblisMaybeIdents	LblisMaybeIdents.yaml
Lbl'Hash'typeNameIs'LParUndsCommUndsRParUnds'RT-TYPES'Unds'Bool'Unds'TypeInfo'Unds'String	Lbl'Hash'typeNameIs'LParUndsCommUndsRParUnds'RT-TYPES'Unds'Bool'Unds'TypeInfo'Unds'String.yaml
Lblproject'Coln'Primitive	Lblproject'Coln'Primitive.yaml
Lblproject'Coln'TerminatorKind'ColnColn'Drop'Coln'target	Lblproject'Coln'TerminatorKind'ColnColn'Drop'Coln'target.yaml
Lblproject'Coln'mk'LParUndsCommUndsCommUndsCommUndsRParUnds'TYPES'Unds'VariantsShapeMultiple'Unds'Scalar'Unds'TagEncoding'Unds'MIRInt'Unds'LayoutShapes'Coln'tag	Lblproject'Coln'mk'LParUndsCommUndsCommUndsCommUndsRParUnds'TYPES'Unds'VariantsShapeMultiple'Unds'Scalar'Unds'TagEncoding'Unds'MIRInt'Unds'LayoutShapes'Coln'tag.yaml
LbllookupAlloc8	LbllookupAlloc8.yaml
LblisLocalsCellOpt	LblisLocalsCellOpt.yaml
Lbl'Hash'adjustRef'LParUndsCommUndsRParUnds'RT-DATA'Unds'Value'Unds'Value'Unds'Int	Lbl'Hash'adjustRef'LParUndsCommUndsRParUnds'RT-DATA'Unds'Value'Unds'Value'Unds'Int.yaml
Lbl'Unds-LT-Eqls'String'UndsUnds'STRING-COMMON'Unds'Bool'Unds'String'Unds'String	Lbl'Unds-LT-Eqls'String'UndsUnds'STRING-COMMON'Unds'Bool'Unds'String'Unds'String.yaml
LblisUncheckedShift'LParUndsRParUnds'RT-DATA'Unds'Bool'Unds'BinOp	LblisUncheckedShift'LParUndsRParUnds'RT-DATA'Unds'Bool'Unds'BinOp.yaml
Lblproject'Coln'TyKind	Lblproject'Coln'TyKind.yaml
LblisFakeBorrowKind	LblisFakeBorrowKind.yaml
Lblproject'Coln'mirConst'LParUndsCommUndsCommUndsRParUnds'TYPES'Unds'MirConst'Unds'ConstantKind'Unds'Ty'Unds'MirConstId'Coln'id	Lblproject'Coln'mirConst'LParUndsCommUndsCommUndsRParUnds'TYPES'Unds'MirConst'Unds'ConstantKind'Unds'Ty'Unds'MirConstId'Coln'id.yaml
LblfloorFloat'LParUndsRParUnds'FLOAT'Unds'Float'Unds'Float	LblfloorFloat'LParUndsRParUnds'FLOAT'Unds'Float'Unds'Float.yaml
Lbl'Hash'findVariantIdxFromTy'LParUndsCommUndsRParUnds'RT-DATA'Unds'VariantIdx'Unds'Int'Unds'TypeInfo	Lbl'Hash'findVariantIdxFromTy'LParUndsCommUndsRParUnds'RT-DATA'Unds'VariantIdx'Unds'Int'Unds'TypeInfo.yaml
Lblproject'Coln'fnAbi'LParUndsCommUndsCommUndsCommUndsCommUndsRParUnds'ABI'Unds'FnAbi'Unds'ArgAbis'Unds'ArgAbi'Unds'MIRInt'Unds'CallConvention'Unds'MIRBool'Coln'conv	Lblproject'Coln'fnAbi'LParUndsCommUndsCommUndsCommUndsCommUndsRParUnds'ABI'Unds'FnAbi'Unds'ArgAbis'Unds'ArgAbi'Unds'MIRInt'Unds'CallConvention'Unds'MIRBool'Coln'conv.yaml
Lblproject'Coln'ForeignDef	Lblproject'Coln'ForeignDef.yaml
Lblproject'Coln'CtorKind	Lblproject'Coln'CtorKind.yaml
Lbl'UndsStar'Int'Unds'	Lbl'UndsStar'Int'Unds'.yaml
Lbl'Unds-GT-'Float'UndsUnds'FLOAT'Unds'Bool'Unds'Float'Unds'Float	Lbl'Unds-GT-'Float'UndsUnds'FLOAT'Unds'Bool'Unds'Float'Unds'Float.yaml
Lblproject'Coln'ImplPolarity	Lblproject'Coln'ImplPolarity.yaml
LblisCoroutineWitnessDef	LblisCoroutineWitnessDef.yaml
Lblproject'Coln'genericParamDef'LParUndsCommUndsCommUndsCommUndsCommUndsRParUnds'TYPES'Unds'GenericParamDef'Unds'Symbol'Unds'GenericDef'Unds'MIRInt'Unds'MIRBool'Unds'GenericParamDefKind'Coln'pureWrtDrop	Lblproject'Coln'genericParamDef'LParUndsCommUndsCommUndsCommUndsCommUndsRParUnds'TYPES'Unds'GenericParamDef'Unds'Symbol'Unds'GenericDef'Unds'MIRInt'Unds'MIRBool'Unds'GenericParamDefKind'Coln'pureWrtDrop.yaml
Lblproject'Coln'ForeignModuleDef	Lblproject'Coln'ForeignModuleDef.yaml
LblisDefId	LblisDefId.yaml
Lblproject'Coln'mk'LParUndsCommUndsCommUndsCommUndsRParUnds'TYPES'Unds'VariantsShapeMultiple'Unds'Scalar'Unds'TagEncoding'Unds'MIRInt'Unds'LayoutShapes'Coln'variants	Lblproject'Coln'mk'LParUndsCommUndsCommUndsCommUndsRParUnds'TYPES'Unds'VariantsShapeMultiple'Unds'Scalar'Unds'TagEncoding'Unds'MIRInt'Unds'LayoutShapes'Coln'variants.yaml
Lblproject'Coln'mk'LParUndsRParUnds'TYPES'Unds'ValueAbiAggregate'Unds'MIRBool'Coln'sized	Lblproject'Coln'mk'LParUndsRParUnds'TYPES'Unds'ValueAbiAggregate'Unds'MIRBool'Coln'sized.yaml
Lblproject'Coln'generics'LParUndsCommUndsCommUndsCommUndsCommUndsCommUndsCommUndsRParUnds'TYPES'Unds'Generics'Unds'MaybeGenericDef'Unds'MIRInt'Unds'GenericParamDefs'Unds'GenericDefAndIdxPairs'Unds'MIRBool'Unds'MaybeSpan'Unds'MaybeInt'Coln'hostEffectIndex	Lblproject'Coln'generics'LParUndsCommUndsCommUndsCommUndsCommUndsCommUndsCommUndsRParUnds'TYPES'Unds'Generics'Unds'MaybeGenericDef'Unds'MIRInt'Unds'GenericParamDefs'Unds'GenericDefAndIdxPairs'Unds'MIRBool'Unds'MaybeSpan'Unds'MaybeInt'Coln'h116.yaml
LblisContext	LblisContext.yaml
Lbl'Unds-GT-'Int'Unds'	Lbl'Unds-GT-'Int'Unds'.yaml
Lblproject'Coln'AllocId	Lblproject'Coln'AllocId.yaml
Lblproject'Coln'GenericArg	Lblproject'Coln'GenericArg.yaml
Lblproject'Coln'UnevaluatedConst	Lblproject'Coln'UnevaluatedConst.yaml
Lblproject'Coln'MachineSizes	Lblproject'Coln'MachineSizes.yaml
Lblproject'Coln'ProjectionPredicate	Lblproject'Coln'ProjectionPredicate.yaml
LblisNonDivergingIntrinsic	LblisNonDivergingIntrinsic.yaml
LblisExistentialPredicate	LblisExistentialPredicate.yaml
LblisGenerics	LblisGenerics.yaml
Lblproject'Coln'fnSig'LParUndsCommUndsCommUndsCommUndsRParUnds'TYPES'Unds'FnSig'Unds'Tys'Unds'MIRBool'Unds'Safety'Unds'Abi'Coln'cVaradic	Lblproject'Coln'fnSig'LParUndsCommUndsCommUndsCommUndsRParUnds'TYPES'Unds'FnSig'Unds'Tys'Unds'MIRBool'Unds'Safety'Unds'Abi'Coln'cVaradic.yaml
Lblproject'Coln'ConstDef	Lblproject'Coln'ConstDef.yaml
Lblproject'Coln'BrNamedDef	Lblproject'Coln'BrNamedDef.yaml
Lblproject'Coln'Scalar	Lblproject'Coln'Scalar.yaml
Lblproject'Coln'existentialTraitRef'LParUndsCommUndsRParUnds'TYPES'Unds'ExistentialTraitRef'Unds'TraitDef'Unds'GenericArgs'Coln'defId	Lblproject'Coln'existentialTraitRef'LParUndsCommUndsRParUnds'TYPES'Unds'ExistentialTraitRef'Unds'TraitDef'Unds'GenericArgs'Coln'defId.yaml
LbllookupTy8	LbllookupTy8.yaml
Lblproject'Coln'MaybeIdents	Lblproject'Coln'MaybeIdents.yaml
LblisTyConst	LblisTyConst.yaml
Lblproject'Coln'TraitDecl	Lblproject'Coln'TraitDecl.yaml
LblisBranch	LblisBranch.yaml
LblisCurrentFuncCellOpt	LblisCurrentFuncCellOpt.yaml
LblinitGeneratedTopCell	LblinitGeneratedTopCell.yaml
LblMap'Coln'lookupOrDefault	LblMap'Coln'lookupOrDefault.yaml
LblisUserTypeAnnotationIndex	LblisUserTypeAnnotationIndex.yaml
Lblproject'Coln'MaybeFieldIdx	Lblproject'Coln'MaybeFieldIdx.yaml
Lbl'UndsEqlsEqls'Int'Unds'	Lbl'UndsEqlsEqls'Int'Unds'.yaml
Lblproject'Coln'tyAndLayout'LParUndsCommUndsRParUnds'ABI'Unds'TyAndLayout'Unds'Ty'Unds'Layout'Coln'ty	Lblproject'Coln'tyAndLayout'LParUndsCommUndsRParUnds'ABI'Unds'TyAndLayout'Unds'Ty'Unds'Layout'Coln'ty.yaml
Lblproject'Coln'Abi'ColnColn'Stdcall'Coln'unwind	Lblproject'Coln'Abi'ColnColn'Stdcall'Coln'unwind.yaml
LblisShift'LParUndsRParUnds'RT-DATA'Unds'Bool'Unds'BinOp	LblisShift'LParUndsRParUnds'RT-DATA'Unds'Bool'Unds'BinOp.yaml
Lblproject'Coln'body'LParUndsCommUndsCommUndsCommUndsCommUndsCommUndsRParUnds'BODY'Unds'Body'Unds'BasicBlocks'Unds'LocalDecls'Unds'MIRInt'Unds'VarDebugInfos'Unds'MaybeLocal'Unds'Span'Coln'span	Lblproject'Coln'body'LParUndsCommUndsCommUndsCommUndsCommUndsCommUndsRParUnds'BODY'Unds'Body'Unds'BasicBlocks'Unds'LocalDecls'Unds'MIRInt'Unds'VarDebugInfos'Unds'MaybeLocal'Unds'Span'Coln'span.yaml
LblisBoundTy	LblisBoundTy.yaml
Lblproject'Coln'Pattern	Lblproject'Coln'Pattern.yaml
LblisExistentialTraitRef	LblisExistentialTraitRef.yaml
Lblproject'Coln'MaybeGenericDef	Lblproject'Coln'MaybeGenericDef.yaml
Lblproject'Coln'fnAbi'LParUndsCommUndsCommUndsCommUndsCommUndsRParUnds'ABI'Unds'FnAbi'Unds'ArgAbis'Unds'ArgAbi'Unds'MIRInt'Unds'CallConvention'Unds'MIRBool'Coln'cVariadic	Lblproject'Coln'fnAbi'LParUndsCommUndsCommUndsCommUndsCommUndsRParUnds'ABI'Unds'FnAbi'Unds'ArgAbis'Unds'ArgAbi'Unds'MIRInt'Unds'CallConvention'Unds'MIRBool'Coln'cVariadic.yaml
LblinitUnwindCell	LblinitUnwindCell.yaml
Lblproject'Coln'Metadata	Lblproject'Coln'Metadata.yaml
Lblproject'Coln'Map	Lblproject'Coln'Map.yaml
LblisTerminator	LblisTerminator.yaml
LblisCrate	LblisCrate.yaml
Lblproject'Coln'MonoItemKind'ColnColn'MonoItemFn'Coln'body	Lblproject'Coln'MonoItemKind'ColnColn'MonoItemFn'Coln'body.yaml
LblisInTy	LblisInTy.yaml
Lblproject'Coln'ExistentialTraitRef	Lblproject'Coln'ExistentialTraitRef.yaml
Lblproject'Coln'body'LParUndsCommUndsCommUndsCommUndsCommUndsCommUndsRParUnds'BODY'Unds'Body'Unds'BasicBlocks'Unds'LocalDecls'Unds'MIRInt'Unds'VarDebugInfos'Unds'MaybeLocal'Unds'Span'Coln'spreadArg	Lblproject'Coln'body'LParUndsCommUndsCommUndsCommUndsCommUndsCommUndsRParUnds'BODY'Unds'Body'Unds'BasicBlocks'Unds'LocalDecls'Unds'MIRInt'Unds'VarDebugInfos'Unds'MaybeLocal'Unds'Span'Coln'spreadArg.yaml
Lblproject'Coln'BoundVariableKind	Lblproject'Coln'BoundVariableKind.yaml
Lblproject'Coln'PointerCoercion	Lblproject'Coln'PointerCoercion.yaml
Lblproject'Coln'binderForFnSig'LParUndsCommUndsRParUnds'TYPES'Unds'BinderForFnSig'Unds'FnSig'Unds'BoundVariableKindList'Coln'boundVars	Lblproject'Coln'binderForFnSig'LParUndsCommUndsRParUnds'TYPES'Unds'BinderForFnSig'Unds'FnSig'Unds'BoundVariableKindList'Coln'boundVars.yaml
Lbl'Hash'transparentFieldTy'LParUndsRParUnds'RT-TYPES'Unds'MaybeTy'Unds'TypeInfo	Lbl'Hash'transparentFieldTy'LParUndsRParUnds'RT-TYPES'Unds'MaybeTy'Unds'TypeInfo.yaml
LblisTargetCell	LblisTargetCell.yaml
LblisRef'LParUndsRParUnds'RT-DATA'Unds'Bool'Unds'Value	LblisRef'LParUndsRParUnds'RT-DATA'Unds'Bool'Unds'Value.yaml
LblisKResult	LblisKResult.yaml
Lblproject'Coln'fnSig'LParUndsCommUndsCommUndsCommUndsRParUnds'TYPES'Unds'FnSig'Unds'Tys'Unds'MIRBool'Unds'Safety'Unds'Abi'Coln'abi	Lblproject'Coln'fnSig'LParUndsCommUndsCommUndsCommUndsRParUnds'TYPES'Unds'FnSig'Unds'Tys'Unds'MIRBool'Unds'Safety'Unds'Abi'Coln'abi.yaml
Lbl'Hash'isUnionType'LParUndsRParUnds'RT-TYPES'Unds'Bool'Unds'TypeInfo	Lbl'Hash'isUnionType'LParUndsRParUnds'RT-TYPES'Unds'Bool'Unds'TypeInfo.yaml
LblisBinderForExistentialTraitRef	LblisBinderForExistentialTraitRef.yaml
Lbl'Hash'switchCanUse'LParUndsRParUnds'KMIR-CONTROL-FLOW'Unds'Bool'Unds'Value	Lbl'Hash'switchCanUse'LParUndsRParUnds'KMIR-CONTROL-FLOW'Unds'Bool'Unds'Value.yaml
Lbl'Hash'localFromFrame'LParUndsCommUndsCommUndsRParUnds'RT-DATA'Unds'Value'Unds'StackFrame'Unds'Local'Unds'Int	Lbl'Hash'localFromFrame'LParUndsCommUndsCommUndsRParUnds'RT-DATA'Unds'Value'Unds'StackFrame'Unds'Local'Unds'Int.yaml
Lblproject'Coln'TypeInfo'ColnColn'EnumType'Coln'layout	Lblproject'Coln'TypeInfo'ColnColn'EnumType'Coln'layout.yaml
LblsignFloat'LParUndsRParUnds'FLOAT'Unds'Bool'Unds'Float	LblsignFloat'LParUndsRParUnds'FLOAT'Unds'Bool'Unds'Float.yaml
Lblproject'Coln'TerminatorKind'ColnColn'Assert'Coln'target	Lblproject'Coln'TerminatorKind'ColnColn'Assert'Coln'target.yaml
Lblproject'Coln'UnOp	Lblproject'Coln'UnOp.yaml
LblbitRangeInt'LParUndsCommUndsCommUndsRParUnds'INT-COMMON'Unds'Int'Unds'Int'Unds'Int'Unds'Int	LblbitRangeInt'LParUndsCommUndsCommUndsRParUnds'INT-COMMON'Unds'Int'Unds'Int'Unds'Int'Unds'Int.yaml
LblgetLocal'LParUndsCommUndsRParUnds'RT-DATA'Unds'TypedLocal'Unds'List'Unds'Int	LblgetLocal'LParUndsCommUndsRParUnds'RT-DATA'Unds'TypedLocal'Unds'List'Unds'Int.yaml
LbloriginSize'LParUndsRParUnds'RT-DATA'Unds'Int'Unds'MetadataSize	LbloriginSize'LParUndsRParUnds'RT-DATA'Unds'Int'Unds'MetadataSize.yaml
Lblproject'Coln'genericParamDef'LParUndsCommUndsCommUndsCommUndsCommUndsRParUnds'TYPES'Unds'GenericParamDef'Unds'Symbol'Unds'GenericDef'Unds'MIRInt'Unds'MIRBool'Unds'GenericParamDefKind'Coln'index	Lblproject'Coln'genericParamDef'LParUndsCommUndsCommUndsCommUndsCommUndsRParUnds'TYPES'Unds'GenericParamDef'Unds'Symbol'Unds'GenericDef'Unds'MIRInt'Unds'MIRBool'Unds'GenericParamDefKind'Coln'index.yaml
LblSet2List'LParUndsRParUnds'COLLECTIONS'Unds'List'Unds'Set	LblSet2List'LParUndsRParUnds'COLLECTIONS'Unds'List'Unds'Set.yaml
LblisNewLocal	LblisNewLocal.yaml
LblisFunctionKind	LblisFunctionKind.yaml
Lblproject'Coln'Filename	Lblproject'Coln'Filename.yaml
LblisTys	LblisTys.yaml
Lblproject'Coln'fieldDef'LParUndsCommUndsRParUnds'TYPES'Unds'FieldDef'Unds'DefId'Unds'Symbol'Coln'name	Lblproject'Coln'fieldDef'LParUndsCommUndsRParUnds'TYPES'Unds'FieldDef'Unds'DefId'Unds'Symbol'Coln'name.yaml
Lblproject'Coln'WrappingRange	Lblproject'Coln'WrappingRange.yaml
LblisTyConstKind	LblisTyConstKind.yaml
Lblproject'Coln'DefId	Lblproject'Coln'DefId.yaml
LblisParamTy	LblisParamTy.yaml
Lbl'UndsAnd-'Int'Unds'	Lbl'UndsAnd-'Int'Unds'.yaml
Lblproject'Coln'body'LParUndsCommUndsCommUndsCommUndsCommUndsCommUndsRParUnds'BODY'Unds'Body'Unds'BasicBlocks'Unds'LocalDecls'Unds'MIRInt'Unds'VarDebugInfos'Unds'MaybeLocal'Unds'Span'Coln'argCount	Lblproject'Coln'body'LParUndsCommUndsCommUndsCommUndsCommUndsCommUndsRParUnds'BODY'Unds'Body'Unds'BasicBlocks'Unds'LocalDecls'Unds'MIRInt'Unds'VarDebugInfos'Unds'MaybeLocal'Unds'Span'Coln'argCount.yaml
Lblproject'Coln'AliasRelationDirection	Lblproject'Coln'AliasRelationDirection.yaml
Lblproject'Coln'IntTy	Lblproject'Coln'IntTy.yaml
Lbl'Hash'isEnumWithoutFields'LParUndsRParUnds'RT-DATA'Unds'Bool'Unds'TypeInfo	Lbl'Hash'isEnumWithoutFields'LParUndsRParUnds'RT-DATA'Unds'Bool'Unds'TypeInfo.yaml
Lblproject'Coln'AggregateKind	Lblproject'Coln'AggregateKind.yaml
LblisDebruijinIndex	LblisDebruijinIndex.yaml
LblisEarlyParamRegion	LblisEarlyParamRegion.yaml
LblisAliasKind	LblisAliasKind.yaml
Lblproject'Coln'VarDebugInfoFragment	Lblproject'Coln'VarDebugInfoFragment.yaml
LblisSourceInfo	LblisSourceInfo.yaml
LblisPrimitive	LblisPrimitive.yaml
LblsignExtendBitRangeInt'LParUndsCommUndsCommUndsRParUnds'INT-COMMON'Unds'Int'Unds'Int'Unds'Int'Unds'Int	LblsignExtendBitRangeInt'LParUndsCommUndsCommUndsRParUnds'INT-COMMON'Unds'Int'Unds'Int'Unds'Int'Unds'Int.yaml
LblisGenericArg	LblisGenericArg.yaml
Lblproject'Coln'GenericParamDef	Lblproject'Coln'GenericParamDef.yaml
Lbl'Hash'buildUpdate'LParUndsCommUndsRParUnds'RT-DATA'Unds'Value'Unds'Value'Unds'Contexts	Lbl'Hash'buildUpdate'LParUndsCommUndsRParUnds'RT-DATA'Unds'Value'Unds'Value'Unds'Contexts.yaml
Lblproject'Coln'genericParamDef'LParUndsCommUndsCommUndsCommUndsCommUndsRParUnds'TYPES'Unds'GenericParamDef'Unds'Symbol'Unds'GenericDef'Unds'MIRInt'Unds'MIRBool'Unds'GenericParamDefKind'Coln'kind	Lblproject'Coln'genericParamDef'LParUndsCommUndsCommUndsCommUndsCommUndsRParUnds'TYPES'Unds'GenericParamDef'Unds'Symbol'Unds'GenericDef'Unds'MIRInt'Unds'MIRBool'Unds'GenericParamDefKind'Coln'kind.yaml
LblisMIRError	LblisMIRError.yaml
Lblproject'Coln'basicBlock'LParUndsCommUndsRParUnds'BODY'Unds'BasicBlock'Unds'Statements'Unds'Terminator'Coln'statements	Lblproject'Coln'basicBlock'LParUndsCommUndsRParUnds'BODY'Unds'BasicBlock'Unds'Statements'Unds'Terminator'Coln'statements.yaml
LblisDynKind	LblisDynKind.yaml
Lblproject'Coln'PrimitiveInt	Lblproject'Coln'PrimitiveInt.yaml
Lblproject'Coln'MaybeTyConst	Lblproject'Coln'MaybeTyConst.yaml
Lblproject'Coln'StackCell	Lblproject'Coln'StackCell.yaml
LblisTyss	LblisTyss.yaml
LblisUserTypeProjection	LblisUserTypeProjection.yaml
Lblproject'Coln'TypeInfo'ColnColn'StructType'Coln'adtDef	Lblproject'Coln'TypeInfo'ColnColn'StructType'Coln'adtDef.yaml
Lbl'Hash'zeroFieldOffset'LParUndsRParUnds'RT-TYPES'Unds'Bool'Unds'MaybeLayoutShape	Lbl'Hash'zeroFieldOffset'LParUndsRParUnds'RT-TYPES'Unds'Bool'Unds'MaybeLayoutShape.yaml
Lblproject'Coln'PredicateKindAndSpanPairs	Lblproject'Coln'PredicateKindAndSpanPairs.yaml
Lblproject'Coln'TerminatorKind'ColnColn'Call'Coln'destination	Lblproject'Coln'TerminatorKind'ColnColn'Call'Coln'destination.yaml
LblinitDestCell	LblinitDestCell.yaml
Lblproject'Coln'traitDecl'LParUndsCommUndsCommUndsCommUndsCommUndsCommUndsCommUndsCommUndsCommUndsCommUndsCommUndsRParUnds'TYPES'Unds'TraitDecl'Unds'TraitDef'Unds'Safety'Unds'MIRBool'Unds'MIRBool'Unds'MIRBool'Unds'MIRBool'Unds'MIRBool'Unds'TraitSpecializationKind'Unds'MaybeIdents'Unds'MIRBool'Unds'MIRBool'Coln'isCoinductive	Lblproject'Coln'traitDecl'LParUndsCommUndsCommUndsCommUndsCommUndsCommUndsCommUndsCommUndsCommUndsCommUndsCommUndsRParUnds'TYPES'Unds'TraitDecl'Unds'TraitDef'Unds'Safety'Unds'MIRBool'Unds'MIRBool'Unds'MIRBool'Unds'MIRBool'Unds'MIRBool'Unds'133.yaml
LblisValueAbiAggregate	LblisValueAbiAggregate.yaml
Lblproject'Coln'AssertMessage	Lblproject'Coln'AssertMessage.yaml
LblisOpaque	LblisOpaque.yaml
Lblproject'Coln'StatementKind'ColnColn'AscribeUserType'Coln'place	Lblproject'Coln'StatementKind'ColnColn'AscribeUserType'Coln'place.yaml
Lblproject'Coln'Signedness	Lblproject'Coln'Signedness.yaml
Lblproject'Coln'mk'LParUndsCommUndsRParUnds'TYPES'Unds'ScalarInitialized'Unds'Primitive'Unds'WrappingRange'Coln'value	Lblproject'Coln'mk'LParUndsCommUndsRParUnds'TYPES'Unds'ScalarInitialized'Unds'Primitive'Unds'WrappingRange'Coln'value.yaml
Lblproject'Coln'CurrentFrameCell	Lblproject'Coln'CurrentFrameCell.yaml
LblisCoroutineSource	LblisCoroutineSource.yaml
Lblproject'Coln'Terminator	Lblproject'Coln'Terminator.yaml
LblminInt'LParUndsCommUndsRParUnds'INT-COMMON'Unds'Int'Unds'Int'Unds'Int	LblminInt'LParUndsCommUndsRParUnds'INT-COMMON'Unds'Int'Unds'Int'Unds'Int.yaml
LblisKItem	LblisKItem.yaml
LblisMaybeTyConst	LblisMaybeTyConst.yaml
Lblproject'Coln'TerminatorKind'ColnColn'Call'Coln'func	Lblproject'Coln'TerminatorKind'ColnColn'Call'Coln'func.yaml
Lblproject'Coln'allocation'Coln'provenance	Lblproject'Coln'allocation'Coln'provenance.yaml
Lbl'Unds'xorInt'Unds'	Lbl'Unds'xorInt'Unds'.yaml
Lblproject'Coln'Region	Lblproject'Coln'Region.yaml
Lbl'Unds'List'Unds'	Lbl'Unds'List'Unds'.yaml
Lblproject'Coln'TargetCell	Lblproject'Coln'TargetCell.yaml
LblisBreakOnFunctionsCellOpt	LblisBreakOnFunctionsCellOpt.yaml
Lblproject'Coln'passModeIndirect'LParUndsCommUndsCommUndsRParUnds'ABI'Unds'PassMode'Unds'Opaque'Unds'Opaque'Unds'MIRBool'Coln'onStack	Lblproject'Coln'passModeIndirect'LParUndsCommUndsCommUndsRParUnds'ABI'Unds'PassMode'Unds'Opaque'Unds'Opaque'Unds'MIRBool'Coln'onStack.yaml
Lblproject'Coln'TypeInfo'ColnColn'EnumType'Coln'adtDef	Lblproject'Coln'TypeInfo'ColnColn'EnumType'Coln'adtDef.yaml
Lblproject'Coln'Coverage	Lblproject'Coln'Coverage.yaml
Lblproject'Coln'ParamDef	Lblproject'Coln'ParamDef.yaml
Lblproject'Coln'lineInfo'LParUndsCommUndsCommUndsCommUndsRParUnds'TYPES'Unds'LineInfo'Unds'MIRInt'Unds'MIRInt'Unds'MIRInt'Unds'MIRInt'Coln'endLine	Lblproject'Coln'lineInfo'LParUndsCommUndsCommUndsCommUndsRParUnds'TYPES'Unds'LineInfo'Unds'MIRInt'Unds'MIRInt'Unds'MIRInt'Unds'MIRInt'Coln'endLine.yaml
Lblproject'Coln'subtypePredicate'LParUndsCommUndsRParUnds'TYPES'Unds'SubtypePredicate'Unds'Ty'Unds'Ty'Coln'b	Lblproject'Coln'subtypePredicate'LParUndsCommUndsRParUnds'TYPES'Unds'SubtypePredicate'Unds'Ty'Unds'Ty'Coln'b.yaml
LblisContexts	LblisContexts.yaml
Lblproject'Coln'mirConst'LParUndsCommUndsCommUndsRParUnds'TYPES'Unds'MirConst'Unds'ConstantKind'Unds'Ty'Unds'MirConstId'Coln'kind	Lblproject'Coln'mirConst'LParUndsCommUndsCommUndsRParUnds'TYPES'Unds'MirConst'Unds'ConstantKind'Unds'Ty'Unds'MirConstId'Coln'kind.yaml
Lblproject'Coln'AdtKind	Lblproject'Coln'AdtKind.yaml
LbllookupTy1	LbllookupTy1.yaml
LblisMaybeInt	LblisMaybeInt.yaml
Lbl'Hash'maybeDynamicSize'LParUndsCommUndsRParUnds'RT-DATA'Unds'MetadataSize'Unds'MetadataSize'Unds'Value	Lbl'Hash'maybeDynamicSize'LParUndsCommUndsRParUnds'RT-DATA'Unds'MetadataSize'Unds'MetadataSize'Unds'Value.yaml
Lblproject'ColnHash'execTerminatorCall'LParUndsCommUndsCommUndsCommUndsCommUndsCommUndsRParUnds'KMIR-CONTROL-FLOW'Unds'KItem'Unds'Ty'Unds'MonoItemKind'Unds'Operands'Unds'Place'Unds'MaybeBasicBlockIdx'Unds'UnwindAction'Coln'target	Lblproject'ColnHash'execTerminatorCall'LParUndsCommUndsCommUndsCommUndsCommUndsCommUndsRParUnds'KMIR-CONTROL-FLOW'Unds'KItem'Unds'Ty'Unds'MonoItemKind'Unds'Operands'Unds'Place'Unds'MaybeBasicBlockIdx'Unds'UnwindAction'Coln'target.yaml
Lblproject'Coln'AliasTy	Lblproject'Coln'AliasTy.yaml
LblisNumTy	LblisNumTy.yaml
LblisTraitDecls	LblisTraitDecls.yaml
Lblproject'Coln'RigidTy	Lblproject'Coln'RigidTy.yaml
Lblproject'Coln'UniverseIndex	Lblproject'Coln'UniverseIndex.yaml
Lblproject'Coln'Context	Lblproject'Coln'Context.yaml
LblgetTyOf'LParUndsCommUndsRParUnds'RT-TYPES'Unds'MaybeTy'Unds'MaybeTy'Unds'ProjectionElems	LblgetTyOf'LParUndsCommUndsRParUnds'RT-TYPES'Unds'MaybeTy'Unds'MaybeTy'Unds'ProjectionElems.yaml
LblisRange'LParUndsRParUnds'RT-DATA'Unds'Bool'Unds'Value	LblisRange'LParUndsRParUnds'RT-DATA'Unds'Bool'Unds'Value.yaml
Lblproject'Coln'TermKind	Lblproject'Coln'TermKind.yaml
Lblproject'Coln'varDebugInfo'LParUndsCommUndsCommUndsCommUndsCommUndsRParUnds'BODY'Unds'VarDebugInfo'Unds'Symbol'Unds'SourceInfo'Unds'MaybeVarDebugInfoFragment'Unds'VarDebugInfoContents'Unds'MaybeInt'Coln'composite	Lblproject'Coln'varDebugInfo'LParUndsCommUndsCommUndsCommUndsCommUndsRParUnds'BODY'Unds'VarDebugInfo'Unds'Symbol'Unds'SourceInfo'Unds'MaybeVarDebugInfoFragment'Unds'VarDebugInfoContents'Unds'MaybeInt'Coln'composite.yaml
Lblproject'Coln'ExistentialPredicate	Lblproject'Coln'ExistentialPredicate.yaml
Lbl'Hash'isIntType'LParUndsRParUnds'RT-NUMBERS'Unds'Bool'Unds'TypeInfo	Lbl'Hash'isIntType'LParUndsRParUnds'RT-NUMBERS'Unds'Bool'Unds'TypeInfo.yaml
LblrfindChar'LParUndsCommUndsCommUndsRParUnds'STRING-COMMON'Unds'Int'Unds'String'Unds'String'Unds'Int	LblrfindChar'LParUndsCommUndsCommUndsRParUnds'STRING-COMMON'Unds'Int'Unds'String'Unds'String'Unds'Int.yaml
Lblproject'Coln'TraitDef	Lblproject'Coln'TraitDef.yaml
Lbl'Stop'Map	Lbl'Stop'Map.yaml
Lblproject'Coln'copyNonOverlapping'LParUndsCommUndsCommUndsRParUnds'BODY'Unds'CopyNonOverlapping'Unds'Operand'Unds'Operand'Unds'Operand'Coln'count	Lblproject'Coln'copyNonOverlapping'LParUndsCommUndsCommUndsRParUnds'BODY'Unds'CopyNonOverlapping'Unds'Operand'Unds'Operand'Unds'Operand'Coln'count.yaml
LblvalueOf'LParUndsRParUnds'RT-VALUE-SYNTAX'Unds'Value'Unds'TypedValue	LblvalueOf'LParUndsRParUnds'RT-VALUE-SYNTAX'Unds'Value'Unds'TypedValue.yaml
LblListItem	LblListItem.yaml
LblisMaybeVarDebugInfoFragment	LblisMaybeVarDebugInfoFragment.yaml
Lblproject'Coln'predicateKindAndSpanPair'LParUndsCommUndsRParUnds'TYPES'Unds'PredicateKindAndSpanPair'Unds'PredicateKind'Unds'Span'Coln'span	Lblproject'Coln'predicateKindAndSpanPair'LParUndsCommUndsRParUnds'TYPES'Unds'PredicateKindAndSpanPair'Unds'PredicateKind'Unds'Span'Coln'span.yaml
Lblproject'Coln'unevaluatedConst'LParUndsCommUndsCommUndsRParUnds'TYPES'Unds'UnevaluatedConst'Unds'ConstDef'Unds'GenericArgs'Unds'MaybePromoted'Coln'def	Lblproject'Coln'unevaluatedConst'LParUndsCommUndsCommUndsRParUnds'TYPES'Unds'UnevaluatedConst'Unds'ConstDef'Unds'GenericArgs'Unds'MaybePromoted'Coln'def.yaml
LblisMaybeOperand	LblisMaybeOperand.yaml
Lblproject'Coln'LayoutShapes	Lblproject'Coln'LayoutShapes.yaml
Lblproject'Coln'PrimitiveType	Lblproject'Coln'PrimitiveType.yaml
Lblproject'Coln'traitDecl'LParUndsCommUndsCommUndsCommUndsCommUndsCommUndsCommUndsCommUndsCommUndsCommUndsCommUndsRParUnds'TYPES'Unds'TraitDecl'Unds'TraitDef'Unds'Safety'Unds'MIRBool'Unds'MIRBool'Unds'MIRBool'Unds'MIRBool'Unds'MIRBool'Unds'TraitSpecializationKind'Unds'MaybeIdents'Unds'MIRBool'Unds'MIRBool'Coln'parenSugar	Lblproject'Coln'traitDecl'LParUndsCommUndsCommUndsCommUndsCommUndsCommUndsCommUndsCommUndsCommUndsCommUndsCommUndsRParUnds'TYPES'Unds'TraitDecl'Unds'TraitDef'Unds'Safety'Unds'MIRBool'Unds'MIRBool'Unds'MIRBool'Unds'MIRBool'Unds'MIRBool'Unds'275.yaml
Lblproject'Coln'MIRBool	Lblproject'Coln'MIRBool.yaml
LblisVarDebugInfos	LblisVarDebugInfos.yaml
LblisInstanceDef	LblisInstanceDef.yaml
LblisCrateItem	LblisCrateItem.yaml
Lblproject'Coln'CurrentFrameCellOpt	Lblproject'Coln'CurrentFrameCellOpt.yaml
LblisLayout	LblisLayout.yaml
LblisMovability	LblisMovability.yaml
Lblproject'Coln'generics'LParUndsCommUndsCommUndsCommUndsCommUndsCommUndsCommUndsRParUnds'TYPES'Unds'Generics'Unds'MaybeGenericDef'Unds'MIRInt'Unds'GenericParamDefs'Unds'GenericDefAndIdxPairs'Unds'MIRBool'Unds'MaybeSpan'Unds'MaybeInt'Coln'parent	Lblproject'Coln'generics'LParUndsCommUndsCommUndsCommUndsCommUndsCommUndsCommUndsRParUnds'TYPES'Unds'Generics'Unds'MaybeGenericDef'Unds'MIRInt'Unds'GenericParamDefs'Unds'GenericDefAndIdxPairs'Unds'MIRBool'Unds'MaybeSpan'Unds'MaybeInt'Coln'p279.yaml
Lblproject'Coln'placeholderForBoundRegion'LParUndsCommUndsRParUnds'TYPES'Unds'PlaceholderForBoundRegion'Unds'UniverseIndex'Unds'BoundRegion'Coln'bound	Lblproject'Coln'placeholderForBoundRegion'LParUndsCommUndsRParUnds'TYPES'Unds'PlaceholderForBoundRegion'Unds'UniverseIndex'Unds'BoundRegion'Coln'bound.yaml
Lblproject'Coln'TypeInfo'ColnColn'TupleType'Coln'layout	Lblproject'Coln'TypeInfo'ColnColn'TupleType'Coln'layout.yaml
LblreverseBytes'LParUndsRParUnds'BYTES-HOOKED'Unds'Bytes'Unds'Bytes	LblreverseBytes'LParUndsRParUnds'BYTES-HOOKED'Unds'Bytes'Unds'Bytes.yaml
Lblproject'Coln'TypeInfo'ColnColn'StructType'Coln'layout	Lblproject'Coln'TypeInfo'ColnColn'StructType'Coln'layout.yaml
LblisForeignModuleDef	LblisForeignModuleDef.yaml
Lblproject'Coln'TerminatorKind'ColnColn'Assert'Coln'msg	Lblproject'Coln'TerminatorKind'ColnColn'Assert'Coln'msg.yaml
LblisSet	LblisSet.yaml
Lblproject'Coln'CopyNonOverlapping	Lblproject'Coln'CopyNonOverlapping.yaml
Lblproject'Coln'varDebugInfo'LParUndsCommUndsCommUndsCommUndsCommUndsRParUnds'BODY'Unds'VarDebugInfo'Unds'Symbol'Unds'SourceInfo'Unds'MaybeVarDebugInfoFragment'Unds'VarDebugInfoContents'Unds'MaybeInt'Coln'sourceInfo	Lblproject'Coln'varDebugInfo'LParUndsCommUndsCommUndsCommUndsCommUndsRParUnds'BODY'Unds'VarDebugInfo'Unds'Symbol'Unds'SourceInfo'Unds'MaybeVarDebugInfoFragment'Unds'VarDebugInfoContents'Unds'MaybeInt'Coln'sourceInfo.yaml
LblisCtorKind	LblisCtorKind.yaml
Lbl'Hash'alignTransparentPlace'LParUndsCommUndsCommUndsRParUnds'RT-DATA'Unds'Place'Unds'Place'Unds'TypeInfo'Unds'TypeInfo	Lbl'Hash'alignTransparentPlace'LParUndsCommUndsCommUndsRParUnds'RT-DATA'Unds'Place'Unds'Place'Unds'TypeInfo'Unds'TypeInfo.yaml
LblisLocalDefId	LblisLocalDefId.yaml
LbllookupAlloc4	LbllookupAlloc4.yaml
Lblproject'Coln'MonoItemKind'ColnColn'MonoItemStatic'Coln'allocation	Lblproject'Coln'MonoItemKind'ColnColn'MonoItemStatic'Coln'allocation.yaml
Lblproject'Coln'TraitRef	Lblproject'Coln'TraitRef.yaml
Lbl'Hash'popTransparentTailTo'LParUndsCommUndsRParUnds'RT-DATA'Unds'ProjectionElems'Unds'ProjectionElems'Unds'TypeInfo	Lbl'Hash'popTransparentTailTo'LParUndsCommUndsRParUnds'RT-DATA'Unds'ProjectionElems'Unds'ProjectionElems'Unds'TypeInfo.yaml
Lbl'Hash'neededBytesForOffsets'LParUndsCommUndsRParUnds'RT-DECODING'Unds'Int'Unds'Tys'Unds'MachineSizes	Lbl'Hash'neededBytesForOffsets'LParUndsCommUndsRParUnds'RT-DECODING'Unds'Int'Unds'Tys'Unds'MachineSizes.yaml
LblinitGeneratedCounterCell	LblinitGeneratedCounterCell.yaml
Lbl'UndsEqlsSlshEqls'String'UndsUnds'STRING-COMMON'Unds'Bool'Unds'String'Unds'String	Lbl'UndsEqlsSlshEqls'String'UndsUnds'STRING-COMMON'Unds'Bool'Unds'String'Unds'String.yaml
LblisBasicBlocks	LblisBasicBlocks.yaml
Lblproject'Coln'UintTy	Lblproject'Coln'UintTy.yaml
LbllookupTy2	LbllookupTy2.yaml
LblinitLocalsCell	LblinitLocalsCell.yaml
Lblproject'Coln'ClauseKind	Lblproject'Coln'ClauseKind.yaml
LblisMaybePlace	LblisMaybePlace.yaml
Lblproject'Coln'TargetCellOpt	Lblproject'Coln'TargetCellOpt.yaml
Lblproject'Coln'TypedLocal	Lblproject'Coln'TypedLocal.yaml
Lblproject'Coln'DynKind	Lblproject'Coln'DynKind.yaml
Lblproject'Coln'lineInfo'LParUndsCommUndsCommUndsCommUndsRParUnds'TYPES'Unds'LineInfo'Unds'MIRInt'Unds'MIRInt'Unds'MIRInt'Unds'MIRInt'Coln'startCol	Lblproject'Coln'lineInfo'LParUndsCommUndsCommUndsCommUndsRParUnds'TYPES'Unds'LineInfo'Unds'MIRInt'Unds'MIRInt'Unds'MIRInt'Unds'MIRInt'Coln'startCol.yaml
LblisAllocId	LblisAllocId.yaml
Lblproject'Coln'Tys	Lblproject'Coln'Tys.yaml
LblisRetValCell	LblisRetValCell.yaml
LblcosFloat'LParUndsRParUnds'FLOAT'Unds'Float'Unds'Float	LblcosFloat'LParUndsRParUnds'FLOAT'Unds'Float'Unds'Float.yaml
LblisVarDebugInfoFragment	LblisVarDebugInfoFragment.yaml
Lblproject'Coln'Align	Lblproject'Coln'Align.yaml
LblisGeneratedCounterCell	LblisGeneratedCounterCell.yaml
Lblproject'Coln'varDebugInfo'LParUndsCommUndsCommUndsCommUndsCommUndsRParUnds'BODY'Unds'VarDebugInfo'Unds'Symbol'Unds'SourceInfo'Unds'MaybeVarDebugInfoFragment'Unds'VarDebugInfoContents'Unds'MaybeInt'Coln'value	Lblproject'Coln'varDebugInfo'LParUndsCommUndsCommUndsCommUndsCommUndsRParUnds'BODY'Unds'VarDebugInfo'Unds'Symbol'Unds'SourceInfo'Unds'MaybeVarDebugInfoFragment'Unds'VarDebugInfoContents'Unds'MaybeInt'Coln'value.yaml
LblisGenericArgs	LblisGenericArgs.yaml
Lbl'Hash'mapOffset'LParUndsCommUndsRParUnds'RT-DATA'Unds'List'Unds'List'Unds'Int	Lbl'Hash'mapOffset'LParUndsCommUndsRParUnds'RT-DATA'Unds'List'Unds'List'Unds'Int.yaml
LbllookupTy6	LbllookupTy6.yaml
LblisStaticDef	LblisStaticDef.yaml
Lblproject'Coln'KmirCellOpt	Lblproject'Coln'KmirCellOpt.yaml
Lblproject'Coln'TypeMapping	Lblproject'Coln'TypeMapping.yaml
Lblproject'Coln'Allocation	Lblproject'Coln'Allocation.yaml
Lblproject'Coln'earlyParamRegion'LParUndsCommUndsRParUnds'TYPES'Unds'EarlyParamRegion'Unds'MIRInt'Unds'Symbol'Coln'index	Lblproject'Coln'earlyParamRegion'LParUndsCommUndsRParUnds'TYPES'Unds'EarlyParamRegion'Unds'MIRInt'Unds'Symbol'Coln'index.yaml
Lblproject'Coln'TerminatorKind'ColnColn'Drop'Coln'place	Lblproject'Coln'TerminatorKind'ColnColn'Drop'Coln'place.yaml
Lblproject'Coln'traitRef'LParUndsCommUndsRParUnds'TYPES'Unds'TraitRef'Unds'TraitDef'Unds'GenericArgs'Coln'defId	Lblproject'Coln'traitRef'LParUndsCommUndsRParUnds'TYPES'Unds'TraitRef'Unds'TraitDef'Unds'GenericArgs'Coln'defId.yaml
Lbl'Unds'andBool'Unds'	Lbl'Unds'andBool'Unds'.yaml
Lblproject'Coln'ItemKind	Lblproject'Coln'ItemKind.yaml
LblisProvenanceMapEntries	LblisProvenanceMapEntries.yaml
Lblproject'Coln'CoroutineKind	Lblproject'Coln'CoroutineKind.yaml
Lblproject'Coln'Body	Lblproject'Coln'Body.yaml
Lblproject'Coln'MaybePlace	Lblproject'Coln'MaybePlace.yaml
Lblproject'Coln'Symbol	Lblproject'Coln'Symbol.yaml
LblisGenericPredicates	LblisGenericPredicates.yaml
LblBytes2String'LParUndsRParUnds'BYTES-HOOKED'Unds'String'Unds'Bytes	LblBytes2String'LParUndsRParUnds'BYTES-HOOKED'Unds'String'Unds'Bytes.yaml
Lblproject'Coln'Operand	Lblproject'Coln'Operand.yaml
Lblproject'Coln'boundRegion'LParUndsCommUndsRParUnds'TYPES'Unds'BoundRegion'Unds'BoundVar'Unds'BoundRegionKind'Coln'var	Lblproject'Coln'boundRegion'LParUndsCommUndsRParUnds'TYPES'Unds'BoundRegion'Unds'BoundVar'Unds'BoundRegionKind'Coln'var.yaml
Lbl'Hash'withDeref'LParUndsRParUnds'KMIR-INTRINSICS'Unds'Operand'Unds'Operand	Lbl'Hash'withDeref'LParUndsRParUnds'KMIR-INTRINSICS'Unds'Operand'Unds'Operand.yaml
Lblproject'Coln'Abi'ColnColn'Thiscall'Coln'unwind	Lblproject'Coln'Abi'ColnColn'Thiscall'Coln'unwind.yaml
LblisVariance	LblisVariance.yaml
LbllookupTy9	LbllookupTy9.yaml
Lbl'Unds'-Map'UndsUnds'MAP'Unds'Map'Unds'Map'Unds'Map	Lbl'Unds'-Map'UndsUnds'MAP'Unds'Map'Unds'Map'Unds'Map.yaml
Lblproject'Coln'BoundVar	Lblproject'Coln'BoundVar.yaml
Lbl'Hash'lookupMaybeTy'LParUndsRParUnds'RT-TYPES'Unds'TypeInfo'Unds'MaybeTy	Lbl'Hash'lookupMaybeTy'LParUndsRParUnds'RT-TYPES'Unds'TypeInfo'Unds'MaybeTy.yaml
LblisStatementKind	LblisStatementKind.yaml
Lblproject'Coln'MaybeTraitDef	Lblproject'Coln'MaybeTraitDef.yaml
Lblproject'Coln'StatementKind'ColnColn'AscribeUserType'Coln'variance	Lblproject'Coln'StatementKind'ColnColn'AscribeUserType'Coln'variance.yaml
LblisTyAndLayout	LblisTyAndLayout.yaml
LblisCurrentFrameCell	LblisCurrentFrameCell.yaml
Lblproject'Coln'FieldIdx	Lblproject'Coln'FieldIdx.yaml
LblisUintTy	LblisUintTy.yaml
Lblproject'Coln'place'Coln'projection	Lblproject'Coln'place'Coln'projection.yaml
LblisAliasDef	LblisAliasDef.yaml
Lblproject'Coln'projectionPredicate'LParUndsCommUndsRParUnds'TYPES'Unds'ProjectionPredicate'Unds'AliasTy'Unds'TermKind'Coln'term	Lblproject'Coln'projectionPredicate'LParUndsCommUndsRParUnds'TYPES'Unds'ProjectionPredicate'Unds'AliasTy'Unds'TermKind'Coln'term.yaml
Lbl'Hash'intTypeOf'LParUndsRParUnds'RT-NUMBERS'Unds'InTy'Unds'TypeInfo	Lbl'Hash'intTypeOf'LParUndsRParUnds'RT-NUMBERS'Unds'InTy'Unds'TypeInfo.yaml
Lblproject'Coln'layoutShape'LParUndsCommUndsCommUndsCommUndsCommUndsRParUnds'TYPES'Unds'LayoutShape'Unds'FieldsShape'Unds'VariantsShape'Unds'ValueAbi'Unds'Align'Unds'MachineSize'Coln'variants	Lblproject'Coln'layoutShape'LParUndsCommUndsCommUndsCommUndsCommUndsRParUnds'TYPES'Unds'LayoutShape'Unds'FieldsShape'Unds'VariantsShape'Unds'ValueAbi'Unds'Align'Unds'MachineSize'Coln'variants.yaml
LblisStatement	LblisStatement.yaml
Lblproject'Coln'StatementKind'ColnColn'Deinit'Coln'place	Lblproject'Coln'StatementKind'ColnColn'Deinit'Coln'place.yaml
Lblproject'Coln'KmirCellFragment	Lblproject'Coln'KmirCellFragment.yaml
Lblproject'Coln'basicBlock'LParUndsCommUndsRParUnds'BODY'Unds'BasicBlock'Unds'Statements'Unds'Terminator'Coln'terminator	Lblproject'Coln'basicBlock'LParUndsCommUndsRParUnds'BODY'Unds'BasicBlock'Unds'Statements'Unds'Terminator'Coln'terminator.yaml
LblgetFieldTy'LParUndsCommUndsRParUnds'RT-TYPES'Unds'MaybeTy'Unds'TypeInfo'Unds'Int	LblgetFieldTy'LParUndsCommUndsRParUnds'RT-TYPES'Unds'MaybeTy'Unds'TypeInfo'Unds'Int.yaml
LbllookupAlloc6	LbllookupAlloc6.yaml
LblisProjectionElems	LblisProjectionElems.yaml
LblisRigidTy	LblisRigidTy.yaml
LblisTerminatorKind	LblisTerminatorKind.yaml
LblisMachineSize	LblisMachineSize.yaml
LblisTestSort2	LblisTestSort2.yaml
LblisIdents	LblisIdents.yaml
Lblproject'Coln'constOperand'LParUndsCommUndsCommUndsRParUnds'BODY'Unds'ConstOperand'Unds'Span'Unds'MaybeUserTypeAnnotationIndex'Unds'MirConst'Coln'userTy	Lblproject'Coln'constOperand'LParUndsCommUndsCommUndsRParUnds'BODY'Unds'ConstOperand'Unds'Span'Unds'MaybeUserTypeAnnotationIndex'Unds'MirConst'Coln'userTy.yaml
Lblproject'Coln'Tyss	Lblproject'Coln'Tyss.yaml
LblisTagEncoding	LblisTagEncoding.yaml
Lblproject'Coln'Pgm	Lblproject'Coln'Pgm.yaml
Lblproject'Coln'TerminatorKind'ColnColn'InlineAsm'Coln'options	Lblproject'Coln'TerminatorKind'ColnColn'InlineAsm'Coln'options.yaml
Lblproject'Coln'sourceInfo'LParUndsCommUndsRParUnds'BODY'Unds'SourceInfo'Unds'Span'Unds'SourceScope'Coln'span	Lblproject'Coln'sourceInfo'LParUndsCommUndsRParUnds'BODY'Unds'SourceInfo'Unds'Span'Unds'SourceScope'Coln'span.yaml
LblisCoroutineDesugaring	LblisCoroutineDesugaring.yaml
Lblproject'Coln'Ty	Lblproject'Coln'Ty.yaml
LblisRetagKind	LblisRetagKind.yaml
Lblproject'Coln'MutBorrowKind	Lblproject'Coln'MutBorrowKind.yaml
LblisOneOf'LParUndsCommUndsRParUnds'KMIR-LEMMAS'Unds'Bool'Unds'Int'Unds'Discriminants	LblisOneOf'LParUndsCommUndsRParUnds'KMIR-LEMMAS'Unds'Bool'Unds'Int'Unds'Discriminants.yaml
Lbl'Hash'typeName'LParUndsRParUnds'RT-TYPES'Unds'String'Unds'TypeInfo	Lbl'Hash'typeName'LParUndsRParUnds'RT-TYPES'Unds'String'Unds'TypeInfo.yaml
Lblproject'Coln'LocalDefId	Lblproject'Coln'LocalDefId.yaml
LblinitStackCell	LblinitStackCell.yaml
LblpushList	LblpushList.yaml
LblisSymbol	LblisSymbol.yaml
Lblproject'Coln'patternRange'LParUndsCommUndsCommUndsRParUnds'TYPES'Unds'Pattern'Unds'MaybeTyConst'Unds'MaybeTyConst'Unds'MIRBool'Coln'start	Lblproject'Coln'patternRange'LParUndsCommUndsCommUndsRParUnds'TYPES'Unds'Pattern'Unds'MaybeTyConst'Unds'MaybeTyConst'Unds'MIRBool'Coln'start.yaml
Lblproject'Coln'SwitchTargets	Lblproject'Coln'SwitchTargets.yaml
Lbl'UndsLSqBUnds-LT-'-undef'RSqB'	Lbl'UndsLSqBUnds-LT-'-undef'RSqB'.yaml
Lblproject'Coln'CoroutineDef	Lblproject'Coln'CoroutineDef.yaml
Lbl'Hash'elemSize'LParUndsRParUnds'RT-DECODING'Unds'Int'Unds'TypeInfo	Lbl'Hash'elemSize'LParUndsRParUnds'RT-DECODING'Unds'Int'Unds'TypeInfo.yaml
Lbl'Unds-LT-'Int'Unds'	Lbl'Unds-LT-'Int'Unds'.yaml
LblisLayoutShape	LblisLayoutShape.yaml
Lblproject'Coln'GenericParamDefKind	Lblproject'Coln'GenericParamDefKind.yaml
Lblproject'Coln'existentialTraitRef'LParUndsCommUndsRParUnds'TYPES'Unds'ExistentialTraitRef'Unds'TraitDef'Unds'GenericArgs'Coln'genericArgs	Lblproject'Coln'existentialTraitRef'LParUndsCommUndsRParUnds'TYPES'Unds'ExistentialTraitRef'Unds'TraitDef'Unds'GenericArgs'Coln'genericArgs.yaml
Lblproject'Coln'FunctionKind	Lblproject'Coln'FunctionKind.yaml
Lblproject'Coln'inlineAsmOperand'LParUndsCommUndsCommUndsRParUnds'BODY'Unds'InlineAsmOperand'Unds'MaybeOperand'Unds'MaybePlace'Unds'MIRString'Coln'rawPtr	Lblproject'Coln'inlineAsmOperand'LParUndsCommUndsCommUndsRParUnds'BODY'Unds'InlineAsmOperand'Unds'MaybeOperand'Unds'MaybePlace'Unds'MIRString'Coln'rawPtr.yaml
Lblproject'Coln'RetValCell	Lblproject'Coln'RetValCell.yaml
Lblproject'Coln'TypeInfo'ColnColn'EnumType'Coln'fields	Lblproject'Coln'TypeInfo'ColnColn'EnumType'Coln'fields.yaml
Lblproject'Coln'machineInfo'LParUndsCommUndsRParUnds'TARGET'Unds'MachineInfo'Unds'Endian'Unds'MachineSize'Coln'pointerWidth	Lblproject'Coln'machineInfo'LParUndsCommUndsRParUnds'TARGET'Unds'MachineInfo'Unds'Endian'Unds'MachineSize'Coln'pointerWidth.yaml
Lblproject'Coln'Operands	Lblproject'Coln'Operands.yaml
Lblproject'Coln'statement'LParUndsCommUndsRParUnds'BODY'Unds'Statement'Unds'StatementKind'Unds'Span'Coln'span	Lblproject'Coln'statement'LParUndsCommUndsRParUnds'BODY'Unds'Statement'Unds'StatementKind'Unds'Span'Coln'span.yaml
LblmaxValueFloat'LParUndsCommUndsRParUnds'FLOAT'Unds'Float'Unds'Int'Unds'Int	LblmaxValueFloat'LParUndsCommUndsRParUnds'FLOAT'Unds'Float'Unds'Int'Unds'Int.yaml
LblisRangeInclusiveForVariantIdx	LblisRangeInclusiveForVariantIdx.yaml
Lblproject'Coln'TerminatorKind'ColnColn'InlineAsm'Coln'unwind	Lblproject'Coln'TerminatorKind'ColnColn'InlineAsm'Coln'unwind.yaml
Lblproject'Coln'MonoItemKind'ColnColn'MonoItemFn'Coln'id	Lblproject'Coln'MonoItemKind'ColnColn'MonoItemFn'Coln'id.yaml
LblisUniverseIndex	LblisUniverseIndex.yaml
Lblproject'Coln'TypeInfo'ColnColn'UnionType'Coln'adtDef	Lblproject'Coln'TypeInfo'ColnColn'UnionType'Coln'adtDef.yaml
Lblkeys'LParUndsRParUnds'MAP'Unds'Set'Unds'Map	Lblkeys'LParUndsRParUnds'MAP'Unds'Set'Unds'Map.yaml
Lblproject'Coln'UnwindCell	Lblproject'Coln'UnwindCell.yaml
Lblproject'Coln'AliasDef	Lblproject'Coln'AliasDef.yaml
Lblproject'Coln'MaybeTy	Lblproject'Coln'MaybeTy.yaml
Lblproject'Coln'body'LParUndsCommUndsCommUndsCommUndsCommUndsCommUndsRParUnds'BODY'Unds'Body'Unds'BasicBlocks'Unds'LocalDecls'Unds'MIRInt'Unds'VarDebugInfos'Unds'MaybeLocal'Unds'Span'Coln'blocks	Lblproject'Coln'body'LParUndsCommUndsCommUndsCommUndsCommUndsCommUndsRParUnds'BODY'Unds'Body'Unds'BasicBlocks'Unds'LocalDecls'Unds'MIRInt'Unds'VarDebugInfos'Unds'MaybeLocal'Unds'Span'Coln'blocks.yaml
LbllookupAlloc1	LbllookupAlloc1.yaml
LblisSourceScope	LblisSourceScope.yaml
Lblproject'Coln'MaybeLocal	Lblproject'Coln'MaybeLocal.yaml
Lblproject'Coln'RetagKind	Lblproject'Coln'RetagKind.yaml
Lblproject'Coln'LocalDecl	Lblproject'Coln'LocalDecl.yaml
LblisVariantsShapeMultiple	LblisVariantsShapeMultiple.yaml
Lblproject'Coln'Abi'ColnColn'SysV64'Coln'unwind	Lblproject'Coln'Abi'ColnColn'SysV64'Coln'unwind.yaml
Lblite	Lblite.yaml
Lblproject'Coln'RetValCellOpt	Lblproject'Coln'RetValCellOpt.yaml
LblisAliasRelationDirection	LblisAliasRelationDirection.yaml
Lblproject'Coln'PlaceholderForBoundRegion	Lblproject'Coln'PlaceholderForBoundRegion.yaml
Lblproject'Coln'traitPredicate'LParUndsCommUndsRParUnds'TYPES'Unds'TraitPredicate'Unds'TraitDef'Unds'PredicatePolarity'Coln'traitDef	Lblproject'Coln'traitPredicate'LParUndsCommUndsRParUnds'TYPES'Unds'TraitPredicate'Unds'TraitDef'Unds'PredicatePolarity'Coln'traitDef.yaml
LblisStackCellOpt	LblisStackCellOpt.yaml
Lblproject'Coln'BasicBlockIdx	Lblproject'Coln'BasicBlockIdx.yaml
Lblproject'Coln'Branches	Lblproject'Coln'Branches.yaml
Lblproject'Coln'layoutShape'LParUndsCommUndsCommUndsCommUndsCommUndsRParUnds'TYPES'Unds'LayoutShape'Unds'FieldsShape'Unds'VariantsShape'Unds'ValueAbi'Unds'Align'Unds'MachineSize'Coln'fields	Lblproject'Coln'layoutShape'LParUndsCommUndsCommUndsCommUndsCommUndsRParUnds'TYPES'Unds'LayoutShape'Unds'FieldsShape'Unds'VariantsShape'Unds'ValueAbi'Unds'Align'Unds'MachineSize'Coln'fields.yaml
LblisTypedValue	LblisTypedValue.yaml
Lblproject'Coln'rangeInclusiveForVariantIdx'LParUndsCommUndsRParUnds'ABI'Unds'RangeInclusiveForVariantIdx'Unds'VariantIdx'Unds'VariantIdx'Coln'end	Lblproject'Coln'rangeInclusiveForVariantIdx'LParUndsCommUndsRParUnds'ABI'Unds'RangeInclusiveForVariantIdx'Unds'VariantIdx'Unds'VariantIdx'Coln'end.yaml
LblisLocalDecl	LblisLocalDecl.yaml
Lblproject'Coln'TerminatorKind'ColnColn'Assert'Coln'unwind	Lblproject'Coln'TerminatorKind'ColnColn'Assert'Coln'unwind.yaml
Lblproject'Coln'traitDecl'LParUndsCommUndsCommUndsCommUndsCommUndsCommUndsCommUndsCommUndsCommUndsCommUndsCommUndsRParUnds'TYPES'Unds'TraitDecl'Unds'TraitDef'Unds'Safety'Unds'MIRBool'Unds'MIRBool'Unds'MIRBool'Unds'MIRBool'Unds'MIRBool'Unds'TraitSpecializationKind'Unds'MaybeIdents'Unds'MIRBool'Unds'MIRBool'Coln'implementViaObject	Lblproject'Coln'traitDecl'LParUndsCommUndsCommUndsCommUndsCommUndsCommUndsCommUndsCommUndsCommUndsCommUndsCommUndsRParUnds'TYPES'Unds'TraitDecl'Unds'TraitDef'Unds'Safety'Unds'MIRBool'Unds'MIRBool'Unds'MIRBool'Unds'MIRBool'Unds'MIRBool'Unds'452.yaml
Lblproject'Coln'InTy	Lblproject'Coln'InTy.yaml
Lblproject'Coln'traitDecl'LParUndsCommUndsCommUndsCommUndsCommUndsCommUndsCommUndsCommUndsCommUndsCommUndsCommUndsRParUnds'TYPES'Unds'TraitDecl'Unds'TraitDef'Unds'Safety'Unds'MIRBool'Unds'MIRBool'Unds'MIRBool'Unds'MIRBool'Unds'MIRBool'Unds'TraitSpecializationKind'Unds'MaybeIdents'Unds'MIRBool'Unds'MIRBool'Coln'skipArrayDuringMethodDispatch	Lblproject'Coln'traitDecl'LParUndsCommUndsCommUndsCommUndsCommUndsCommUndsCommUndsCommUndsCommUndsCommUndsCommUndsRParUnds'TYPES'Unds'TraitDecl'Unds'TraitDef'Unds'Safety'Unds'MIRBool'Unds'MIRBool'Unds'MIRBool'Unds'MIRBool'Unds'MIRBool'Unds'456.yaml
Lblproject'Coln'traitRef'LParUndsCommUndsRParUnds'TYPES'Unds'TraitRef'Unds'TraitDef'Unds'GenericArgs'Coln'args	Lblproject'Coln'traitRef'LParUndsCommUndsRParUnds'TYPES'Unds'TraitRef'Unds'TraitDef'Unds'GenericArgs'Coln'args.yaml
Lblproject'Coln'argAbi'LParUndsCommUndsCommUndsRParUnds'ABI'Unds'ArgAbi'Unds'Ty'Unds'Layout'Unds'PassMode'Coln'ty	Lblproject'Coln'argAbi'LParUndsCommUndsCommUndsRParUnds'ABI'Unds'ArgAbi'Unds'Ty'Unds'Layout'Unds'PassMode'Coln'ty.yaml
Lblproject'Coln'GeneratedTopCell	Lblproject'Coln'GeneratedTopCell.yaml
Lbl'UndsPlus'Int'Unds'	Lbl'UndsPlus'Int'Unds'.yaml
Lblproject'Coln'NewLocal	Lblproject'Coln'NewLocal.yaml
LblisItemKind	LblisItemKind.yaml
LblisSignedness	LblisSignedness.yaml
LblsizeMap	LblsizeMap.yaml
Lbl'UndsPlus'String'UndsUnds'STRING-COMMON'Unds'String'Unds'String'Unds'String	Lbl'UndsPlus'String'UndsUnds'STRING-COMMON'Unds'String'Unds'String'Unds'String.yaml
Lblproject'Coln'WriteTo	Lblproject'Coln'WriteTo.yaml
LblisPattern	LblisPattern.yaml
Lblproject'Coln'generics'LParUndsCommUndsCommUndsCommUndsCommUndsCommUndsCommUndsRParUnds'TYPES'Unds'Generics'Unds'MaybeGenericDef'Unds'MIRInt'Unds'GenericParamDefs'Unds'GenericDefAndIdxPairs'Unds'MIRBool'Unds'MaybeSpan'Unds'MaybeInt'Coln'paramDefIdToIndex	Lblproject'Coln'generics'LParUndsCommUndsCommUndsCommUndsCommUndsCommUndsCommUndsRParUnds'TYPES'Unds'Generics'Unds'MaybeGenericDef'Unds'MIRInt'Unds'GenericParamDefs'Unds'GenericDefAndIdxPairs'Unds'MIRBool'Unds'MaybeSpan'Unds'MaybeInt'Coln'p466.yaml
Lbl'UndsEqlsEqls'Bool'Unds'	Lbl'UndsEqlsEqls'Bool'Unds'.yaml
LblisVariantAndFieldIndices	LblisVariantAndFieldIndices.yaml
Lblproject'Coln'FieldsShapeArbitrary	Lblproject'Coln'FieldsShapeArbitrary.yaml
Lblproject'Coln'TypedValue	Lblproject'Coln'TypedValue.yaml
Lblproject'Coln'localDecl'LParUndsCommUndsCommUndsRParUnds'BODY'Unds'LocalDecl'Unds'Ty'Unds'Span'Unds'Mutability'Coln'mut	Lblproject'Coln'localDecl'LParUndsCommUndsCommUndsRParUnds'BODY'Unds'LocalDecl'Unds'Ty'Unds'Span'Unds'Mutability'Coln'mut.yaml
Lblproject'Coln'layoutShape'LParUndsCommUndsCommUndsCommUndsCommUndsRParUnds'TYPES'Unds'LayoutShape'Unds'FieldsShape'Unds'VariantsShape'Unds'ValueAbi'Unds'Align'Unds'MachineSize'Coln'abiAlign	Lblproject'Coln'layoutShape'LParUndsCommUndsCommUndsCommUndsCommUndsRParUnds'TYPES'Unds'LayoutShape'Unds'FieldsShape'Unds'VariantsShape'Unds'ValueAbi'Unds'Align'Unds'MachineSize'Coln'abiAlign.yaml
LblisFnSig	LblisFnSig.yaml
Lblproject'Coln'ExistentialPredicateBinder	Lblproject'Coln'ExistentialPredicateBinder.yaml
LblisCurrentBodyCellOpt	LblisCurrentBodyCellOpt.yaml
Lbl'UndsEqlsSlshEqls'K'Unds'	Lbl'UndsEqlsSlshEqls'K'Unds'.yaml
Lblproject'Coln'machineInfo'LParUndsCommUndsRParUnds'TARGET'Unds'MachineInfo'Unds'Endian'Unds'MachineSize'Coln'endian	Lblproject'Coln'machineInfo'LParUndsCommUndsRParUnds'TARGET'Unds'MachineInfo'Unds'Endian'Unds'MachineSize'Coln'endian.yaml
Lblsize'LParUndsRParUnds'RT-DATA'Unds'Int'Unds'Discriminants	Lblsize'LParUndsRParUnds'RT-DATA'Unds'Int'Unds'Discriminants.yaml
Lblproject'Coln'subtypePredicate'LParUndsCommUndsRParUnds'TYPES'Unds'SubtypePredicate'Unds'Ty'Unds'Ty'Coln'a	Lblproject'Coln'subtypePredicate'LParUndsCommUndsRParUnds'TYPES'Unds'SubtypePredicate'Unds'Ty'Unds'Ty'Coln'a.yaml
LblinitCurrentFuncCell	LblinitCurrentFuncCell.yaml
Lblproject'Coln'fnSig'LParUndsCommUndsCommUndsCommUndsRParUnds'TYPES'Unds'FnSig'Unds'Tys'Unds'MIRBool'Unds'Safety'Unds'Abi'Coln'inputsAndOutput	Lblproject'Coln'fnSig'LParUndsCommUndsCommUndsCommUndsRParUnds'TYPES'Unds'FnSig'Unds'Tys'Unds'MIRBool'Unds'Safety'Unds'Abi'Coln'inputsAndOutput.yaml
Lblproject'Coln'StatementKind'ColnColn'Retag'Coln'kind	Lblproject'Coln'StatementKind'ColnColn'Retag'Coln'kind.yaml
Lblproject'Coln'AdtDef	Lblproject'Coln'AdtDef.yaml
Lblproject'Coln'StatementKind'ColnColn'SetDiscriminant'Coln'variantIndex	Lblproject'Coln'StatementKind'ColnColn'SetDiscriminant'Coln'variantIndex.yaml
Lblproject'Coln'BoundRegionKind	Lblproject'Coln'BoundRegionKind.yaml
LblisTraitDef	LblisTraitDef.yaml
Lblproject'Coln'EarlyParamRegion	Lblproject'Coln'EarlyParamRegion.yaml
LblisMIRInt	LblisMIRInt.yaml
LblisDestCell	LblisDestCell.yaml
LblisGenericParamDef	LblisGenericParamDef.yaml
Lblproject'Coln'Evaluation	Lblproject'Coln'Evaluation.yaml
Lblproject'Coln'MonoItemKind'ColnColn'MonoItemStatic'Coln'id	Lblproject'Coln'MonoItemKind'ColnColn'MonoItemStatic'Coln'id.yaml
Lblproject'Coln'Variance	Lblproject'Coln'Variance.yaml
LblList'Coln'range	LblList'Coln'range.yaml
Lblproject'Coln'TypeInfo'ColnColn'EnumType'Coln'name	Lblproject'Coln'TypeInfo'ColnColn'EnumType'Coln'name.yaml
Lblproject'Coln'mk'LParUndsCommUndsRParUnds'TYPES'Unds'PrimitiveInt'Unds'IntegerLength'Unds'MIRBool'Coln'length	Lblproject'Coln'mk'LParUndsCommUndsRParUnds'TYPES'Unds'PrimitiveInt'Unds'IntegerLength'Unds'MIRBool'Coln'length.yaml
LblisTargetCellOpt	LblisTargetCellOpt.yaml
Lbl'Hash'convertMetadata'LParUndsCommUndsRParUnds'RT-DATA'Unds'Metadata'Unds'Metadata'Unds'TypeInfo	Lbl'Hash'convertMetadata'LParUndsCommUndsRParUnds'RT-DATA'Unds'Metadata'Unds'Metadata'Unds'TypeInfo.yaml
Lblproject'Coln'userTypeProjection'LParUndsCommUndsRParUnds'BODY'Unds'UserTypeProjection'Unds'UserTypeAnnotationIndex'Unds'Opaque'Coln'projection	Lblproject'Coln'userTypeProjection'LParUndsCommUndsRParUnds'BODY'Unds'UserTypeProjection'Unds'UserTypeAnnotationIndex'Unds'Opaque'Coln'projection.yaml
Lblproject'Coln'TypeOutlivesPredicate	Lblproject'Coln'TypeOutlivesPredicate.yaml
Lbl'UndsEqlsSlshEqls'Bool'Unds'	Lbl'UndsEqlsSlshEqls'Bool'Unds'.yaml
LblelemTy'LParUndsRParUnds'RT-TYPES'Unds'MaybeTy'Unds'TypeInfo	LblelemTy'LParUndsRParUnds'RT-TYPES'Unds'MaybeTy'Unds'TypeInfo.yaml
LblisGenericParamDefKind	LblisGenericParamDefKind.yaml
LblisStackFrame	LblisStackFrame.yaml
Lbl'Hash'metadataSize'LParUndsCommUndsRParUnds'RT-TYPES'Unds'MetadataSize'Unds'Ty'Unds'ProjectionElems	Lbl'Hash'metadataSize'LParUndsCommUndsRParUnds'RT-TYPES'Unds'MetadataSize'Unds'Ty'Unds'ProjectionElems.yaml
LblisPointerCoercion	LblisPointerCoercion.yaml
LblnoFields	LblnoFields.yaml
Lblproject'Coln'placeholderForBoundRegion'LParUndsCommUndsRParUnds'TYPES'Unds'PlaceholderForBoundRegion'Unds'UniverseIndex'Unds'BoundRegion'Coln'universe	Lblproject'Coln'placeholderForBoundRegion'LParUndsCommUndsRParUnds'TYPES'Unds'PlaceholderForBoundRegion'Unds'UniverseIndex'Unds'BoundRegion'Coln'universe.yaml
Lblproject'Coln'argAbi'LParUndsCommUndsCommUndsRParUnds'ABI'Unds'ArgAbi'Unds'Ty'Unds'Layout'Unds'PassMode'Coln'layout	Lblproject'Coln'argAbi'LParUndsCommUndsCommUndsRParUnds'ABI'Unds'ArgAbi'Unds'Ty'Unds'Layout'Unds'PassMode'Coln'layout.yaml
Lbl'Hash'switchMatch'LParUndsCommUndsRParUnds'KMIR-CONTROL-FLOW'Unds'Bool'Unds'MIRInt'Unds'Value	Lbl'Hash'switchMatch'LParUndsCommUndsRParUnds'KMIR-CONTROL-FLOW'Unds'Bool'Unds'MIRInt'Unds'Value.yaml
LblisMIRBytes	LblisMIRBytes.yaml
LbllookupAlloc	LbllookupAlloc.yaml
Lblproject'Coln'aliasTy'LParUndsCommUndsRParUnds'TYPES'Unds'AliasTy'Unds'AliasDef'Unds'GenericArgs'Coln'defId	Lblproject'Coln'aliasTy'LParUndsCommUndsRParUnds'TYPES'Unds'AliasTy'Unds'AliasDef'Unds'GenericArgs'Coln'defId.yaml
Lblproject'Coln'terminator'LParUndsCommUndsRParUnds'BODY'Unds'Terminator'Unds'TerminatorKind'Unds'Span'Coln'kind	Lblproject'Coln'terminator'LParUndsCommUndsRParUnds'BODY'Unds'Terminator'Unds'TerminatorKind'Unds'Span'Coln'kind.yaml
Lblproject'Coln'ForeignModule	Lblproject'Coln'ForeignModule.yaml
LblisValueAbi	LblisValueAbi.yaml
LblisMIRString	LblisMIRString.yaml
LblisLocalDecls	LblisLocalDecls.yaml
LblInt2String'LParUndsRParUnds'STRING-COMMON'Unds'String'Unds'Int	LblInt2String'LParUndsRParUnds'STRING-COMMON'Unds'String'Unds'Int.yaml
Lblproject'Coln'MetadataSize	Lblproject'Coln'MetadataSize.yaml
LblisTypeMappings	LblisTypeMappings.yaml
Lblproject'Coln'varDebugInfo'LParUndsCommUndsCommUndsCommUndsCommUndsRParUnds'BODY'Unds'VarDebugInfo'Unds'Symbol'Unds'SourceInfo'Unds'MaybeVarDebugInfoFragment'Unds'VarDebugInfoContents'Unds'MaybeInt'Coln'name	Lblproject'Coln'varDebugInfo'LParUndsCommUndsCommUndsCommUndsCommUndsRParUnds'BODY'Unds'VarDebugInfo'Unds'Symbol'Unds'SourceInfo'Unds'MaybeVarDebugInfoFragment'Unds'VarDebugInfoContents'Unds'MaybeInt'Coln'name.yaml
LblisIntTy	LblisIntTy.yaml
LblisUnwindCellOpt	LblisUnwindCellOpt.yaml
Lblproject'Coln'traitDecl'LParUndsCommUndsCommUndsCommUndsCommUndsCommUndsCommUndsCommUndsCommUndsCommUndsCommUndsRParUnds'TYPES'Unds'TraitDecl'Unds'TraitDef'Unds'Safety'Unds'MIRBool'Unds'MIRBool'Unds'MIRBool'Unds'MIRBool'Unds'MIRBool'Unds'TraitSpecializationKind'Unds'MaybeIdents'Unds'MIRBool'Unds'MIRBool'Coln'hasAutoImpl	Lblproject'Coln'traitDecl'LParUndsCommUndsCommUndsCommUndsCommUndsCommUndsCommUndsCommUndsCommUndsCommUndsCommUndsRParUnds'TYPES'Unds'TraitDecl'Unds'TraitDef'Unds'Safety'Unds'MIRBool'Unds'MIRBool'Unds'MIRBool'Unds'MIRBool'Unds'MIRBool'Unds'525.yaml
Lbl'Hash'projectionsFor'LParUndsCommUndsRParUnds'RT-DATA'Unds'ProjectionElems'Unds'Contexts'Unds'ProjectionElems	Lbl'Hash'projectionsFor'LParUndsCommUndsRParUnds'RT-DATA'Unds'ProjectionElems'Unds'Contexts'Unds'ProjectionElems.yaml
Lblproject'Coln'FakeBorrowKind	Lblproject'Coln'FakeBorrowKind.yaml
Lblproject'Coln'TerminatorKind'ColnColn'Assert'Coln'cond	Lblproject'Coln'TerminatorKind'ColnColn'Assert'Coln'cond.yaml
Lblproject'Coln'Generics	Lblproject'Coln'Generics.yaml
LblMap'Coln'lookup	LblMap'Coln'lookup.yaml
Lblproject'Coln'LineInfo	Lblproject'Coln'LineInfo.yaml
Lblreplace'LParUndsCommUndsCommUndsCommUndsRParUnds'STRING-COMMON'Unds'String'Unds'String'Unds'String'Unds'String'Unds'Int	Lblreplace'LParUndsCommUndsCommUndsCommUndsRParUnds'STRING-COMMON'Unds'String'Unds'String'Unds'String'Unds'String'Unds'Int.yaml
LblfreshInt'LParUndsRParUnds'INT'Unds'Int'Unds'Int	LblfreshInt'LParUndsRParUnds'INT'Unds'Int'Unds'Int.yaml
Lblproject'Coln'existentialPredicateBinder'LParUndsCommUndsRParUnds'TYPES'Unds'ExistentialPredicateBinder'Unds'ExistentialPredicate'Unds'BoundVariableKindList'Coln'boundVars	Lblproject'Coln'existentialPredicateBinder'LParUndsCommUndsRParUnds'TYPES'Unds'ExistentialPredicateBinder'Unds'ExistentialPredicate'Unds'BoundVariableKindList'Coln'boundVars.yaml
Lblproject'Coln'TerminatorKind'ColnColn'Goto'Coln'target	Lblproject'Coln'TerminatorKind'ColnColn'Goto'Coln'target.yaml
Lbl'Hash'decodeOptionTag01'LParUndsCommUndsCommUndsCommUndsRParUnds'RT-DECODING'Unds'Evaluation'Unds'Bytes'Unds'IntegerLength'Unds'Ty'Unds'TypeInfo	Lbl'Hash'decodeOptionTag01'LParUndsCommUndsCommUndsCommUndsRParUnds'RT-DECODING'Unds'Evaluation'Unds'Bytes'Unds'IntegerLength'Unds'Ty'Unds'TypeInfo.yaml
LbllengthString'LParUndsRParUnds'STRING-COMMON'Unds'Int'Unds'String	LbllengthString'LParUndsRParUnds'STRING-COMMON'Unds'Int'Unds'String.yaml
LblcmpOpInt'LParUndsCommUndsCommUndsRParUnds'RT-DATA'Unds'Bool'Unds'BinOp'Unds'Int'Unds'Int	LblcmpOpInt'LParUndsCommUndsCommUndsRParUnds'RT-DATA'Unds'Bool'Unds'BinOp'Unds'Int'Unds'Int.yaml
LblisArithmetic'LParUndsRParUnds'RT-DATA'Unds'Bool'Unds'BinOp	LblisArithmetic'LParUndsRParUnds'RT-DATA'Unds'Bool'Unds'BinOp.yaml
Lbl'Unds'xorBool'Unds'	Lbl'Unds'xorBool'Unds'.yaml
Lblproject'Coln'tyAndLayout'LParUndsCommUndsRParUnds'ABI'Unds'TyAndLayout'Unds'Ty'Unds'Layout'Coln'layout	Lblproject'Coln'tyAndLayout'LParUndsCommUndsRParUnds'ABI'Unds'TyAndLayout'Unds'Ty'Unds'Layout'Coln'layout.yaml
Lblproject'Coln'CallerCell	Lblproject'Coln'CallerCell.yaml
Lblproject'Coln'MIRError	Lblproject'Coln'MIRError.yaml
Lblproject'Coln'KResult	Lblproject'Coln'KResult.yaml
Lblproject'Coln'KItem	Lblproject'Coln'KItem.yaml
Lbl'Hash'lookupDiscrAux'LParUndsCommUndsRParUnds'RT-DATA'Unds'Int'Unds'Discriminants'Unds'VariantIdx	Lbl'Hash'lookupDiscrAux'LParUndsCommUndsRParUnds'RT-DATA'Unds'Int'Unds'Discriminants'Unds'VariantIdx.yaml
Lblproject'Coln'traitPredicate'LParUndsCommUndsRParUnds'TYPES'Unds'TraitPredicate'Unds'TraitDef'Unds'PredicatePolarity'Coln'polarity	Lblproject'Coln'traitPredicate'LParUndsCommUndsRParUnds'TYPES'Unds'TraitPredicate'Unds'TraitDef'Unds'PredicatePolarity'Coln'polarity.yaml
LblisClauseKind	LblisClauseKind.yaml
LblisLayoutShapes	LblisLayoutShapes.yaml
Lblproject'Coln'MaybeSpan	Lblproject'Coln'MaybeSpan.yaml
LblisProjectionPredicate	LblisProjectionPredicate.yaml
LblisFloatTy	LblisFloatTy.yaml
LblisCurrentBodyCell	LblisCurrentBodyCell.yaml
LblinitCurrentFrameCell	LblinitCurrentFrameCell.yaml
Lblproject'Coln'passModeCast'LParUndsCommUndsRParUnds'ABI'Unds'PassMode'Unds'MIRBool'Unds'Opaque'Coln'padI32	Lblproject'Coln'passModeCast'LParUndsCommUndsRParUnds'ABI'Unds'PassMode'Unds'MIRBool'Unds'Opaque'Coln'padI32.yaml
LblisBasicBlock	LblisBasicBlock.yaml
Lblproject'Coln'Evaluation'ColnColn'UnableToDecodePy'Coln'msg	Lblproject'Coln'Evaluation'ColnColn'UnableToDecodePy'Coln'msg.yaml
Lblproject'Coln'projectionPredicate'LParUndsCommUndsRParUnds'TYPES'Unds'ProjectionPredicate'Unds'AliasTy'Unds'TermKind'Coln'projectionTy	Lblproject'Coln'projectionPredicate'LParUndsCommUndsRParUnds'TYPES'Unds'ProjectionPredicate'Unds'AliasTy'Unds'TermKind'Coln'projectionTy.yaml
Lblproject'Coln'MaybeOperand	Lblproject'Coln'MaybeOperand.yaml
Lbl'Hash'projectionsFor'LParUndsRParUnds'RT-DATA'Unds'ProjectionElems'Unds'Contexts	Lbl'Hash'projectionsFor'LParUndsRParUnds'RT-DATA'Unds'ProjectionElems'Unds'Contexts.yaml
LbllookupAlloc7	LbllookupAlloc7.yaml
Lbl'Unds'modInt'Unds'	Lbl'Unds'modInt'Unds'.yaml
LblMap'Coln'update	LblMap'Coln'update.yaml
Lblproject'Coln'Abi'ColnColn'Cdecl'Coln'unwind	Lblproject'Coln'Abi'ColnColn'Cdecl'Coln'unwind.yaml
Lblproject'Coln'existentialPredicateBinder'LParUndsCommUndsRParUnds'TYPES'Unds'ExistentialPredicateBinder'Unds'ExistentialPredicate'Unds'BoundVariableKindList'Coln'value	Lblproject'Coln'existentialPredicateBinder'LParUndsCommUndsRParUnds'TYPES'Unds'ExistentialPredicateBinder'Unds'ExistentialPredicate'Unds'BoundVariableKindList'Coln'value.yaml
Lblproject'Coln'FunctionNames	Lblproject'Coln'FunctionNames.yaml
Lblproject'Coln'PredicateKindAndSpanPair	Lblproject'Coln'PredicateKindAndSpanPair.yaml
LblfindVariantIdx	LblfindVariantIdx.yaml
LblisBody	LblisBody.yaml
Lblproject'Coln'FieldsShape	Lblproject'Coln'FieldsShape.yaml
Lblproject'Coln'paramConst'LParUndsCommUndsRParUnds'TYPES'Unds'ParamConst'Unds'MIRInt'Unds'MIRString'Coln'name	Lblproject'Coln'paramConst'LParUndsCommUndsRParUnds'TYPES'Unds'ParamConst'Unds'MIRInt'Unds'MIRString'Coln'name.yaml
Lblproject'Coln'boundTy'LParUndsCommUndsRParUnds'TYPES'Unds'BoundTy'Unds'MIRInt'Unds'BoundTyKind'Coln'kind	Lblproject'Coln'boundTy'LParUndsCommUndsRParUnds'TYPES'Unds'BoundTy'Unds'MIRInt'Unds'BoundTyKind'Coln'kind.yaml
Lblproject'Coln'MonoItemKind'ColnColn'MonoItemStatic'Coln'name	Lblproject'Coln'MonoItemKind'ColnColn'MonoItemStatic'Coln'name.yaml
LblisRetValCellOpt	LblisRetValCellOpt.yaml
Lblproject'Coln'binderForFnSig'LParUndsCommUndsRParUnds'TYPES'Unds'BinderForFnSig'Unds'FnSig'Unds'BoundVariableKindList'Coln'value	Lblproject'Coln'binderForFnSig'LParUndsCommUndsRParUnds'TYPES'Unds'BinderForFnSig'Unds'FnSig'Unds'BoundVariableKindList'Coln'value.yaml
Lblproject'Coln'ProjectionElem'ColnColn'ConstantIndex'Coln'offset	Lblproject'Coln'ProjectionElem'ColnColn'ConstantIndex'Coln'offset.yaml
Lblproject'Coln'Abi'ColnColn'Vectorcall'Coln'unwind	Lblproject'Coln'Abi'ColnColn'Vectorcall'Coln'unwind.yaml
Lbl'Hash'decodeInteger'LParUndsCommUndsRParUnds'RT-NUMBERS'Unds'Value'Unds'Bytes'Unds'InTy	Lbl'Hash'decodeInteger'LParUndsCommUndsRParUnds'RT-NUMBERS'Unds'Value'Unds'Bytes'Unds'InTy.yaml
Lblproject'Coln'Bool	Lblproject'Coln'Bool.yaml
Lblproject'Coln'GlobalAllocs	Lblproject'Coln'GlobalAllocs.yaml
LblisArgAbi	LblisArgAbi.yaml
Lblproject'Coln'StackFrame'LParUndsCommUndsCommUndsCommUndsCommUndsRParUnds'KMIR-CONFIGURATION'Unds'StackFrame'Unds'Ty'Unds'Place'Unds'MaybeBasicBlockIdx'Unds'UnwindAction'Unds'List'Coln'dest	Lblproject'Coln'StackFrame'LParUndsCommUndsCommUndsCommUndsCommUndsRParUnds'KMIR-CONFIGURATION'Unds'StackFrame'Unds'Ty'Unds'Place'Unds'MaybeBasicBlockIdx'Unds'UnwindAction'Unds'List'Coln'dest.yaml
Lblproject'Coln'BinderForExistentialTraitRef	Lblproject'Coln'BinderForExistentialTraitRef.yaml
LblisConstDef	LblisConstDef.yaml
LblisAllocation	LblisAllocation.yaml
Lbl'Hash'mutabilityOf'LParUndsRParUnds'RT-DATA'Unds'Mutability'Unds'BorrowKind	Lbl'Hash'mutabilityOf'LParUndsRParUnds'RT-DATA'Unds'Mutability'Unds'BorrowKind.yaml
LbllookupAlloc9	LbllookupAlloc9.yaml
LblisIdent	LblisIdent.yaml
LblisRegionOutlivesPredicate	LblisRegionOutlivesPredicate.yaml
LblabsFloat'LParUndsRParUnds'FLOAT'Unds'Float'Unds'Float	LblabsFloat'LParUndsRParUnds'FLOAT'Unds'Float'Unds'Float.yaml
Lblproject'Coln'MaybeVarDebugInfoFragment	Lblproject'Coln'MaybeVarDebugInfoFragment.yaml
Lblproject'Coln'ImplDef	Lblproject'Coln'ImplDef.yaml
LblisBoundVariableKindList	LblisBoundVariableKindList.yaml
LblisCurrentFrameCellFragment	LblisCurrentFrameCellFragment.yaml
Lbl'Unds'Set'Unds'	Lbl'Unds'Set'Unds'.yaml
LblSetItem	LblSetItem.yaml
Lblproject'Coln'generics'LParUndsCommUndsCommUndsCommUndsCommUndsCommUndsCommUndsRParUnds'TYPES'Unds'Generics'Unds'MaybeGenericDef'Unds'MIRInt'Unds'GenericParamDefs'Unds'GenericDefAndIdxPairs'Unds'MIRBool'Unds'MaybeSpan'Unds'MaybeInt'Coln'params	Lblproject'Coln'generics'LParUndsCommUndsCommUndsCommUndsCommUndsCommUndsCommUndsRParUnds'TYPES'Unds'Generics'Unds'MaybeGenericDef'Unds'MIRInt'Unds'GenericParamDefs'Unds'GenericDefAndIdxPairs'Unds'MIRBool'Unds'MaybeSpan'Unds'MaybeInt'Coln'p296.yaml
Lbl'Hash'ptrLocalEq'LParUndsCommUndsRParUnds'RT-DATA'Unds'Bool'Unds'Value'Unds'Value	Lbl'Hash'ptrLocalEq'LParUndsCommUndsRParUnds'RT-DATA'Unds'Bool'Unds'Value'Unds'Value.yaml
Lbl'Hash'bitWidth'LParUndsRParUnds'RT-NUMBERS'Unds'Int'Unds'NumTy	Lbl'Hash'bitWidth'LParUndsRParUnds'RT-NUMBERS'Unds'Int'Unds'NumTy.yaml
Lblproject'Coln'ProvenanceMap	Lblproject'Coln'ProvenanceMap.yaml
Lblproject'Coln'generics'LParUndsCommUndsCommUndsCommUndsCommUndsCommUndsCommUndsRParUnds'TYPES'Unds'Generics'Unds'MaybeGenericDef'Unds'MIRInt'Unds'GenericParamDefs'Unds'GenericDefAndIdxPairs'Unds'MIRBool'Unds'MaybeSpan'Unds'MaybeInt'Coln'hasLateBoundRegions	Lblproject'Coln'generics'LParUndsCommUndsCommUndsCommUndsCommUndsCommUndsCommUndsRParUnds'TYPES'Unds'Generics'Unds'MaybeGenericDef'Unds'MIRInt'Unds'GenericParamDefs'Unds'GenericDefAndIdxPairs'Unds'MIRBool'Unds'MaybeSpan'Unds'MaybeInt'Coln'h600.yaml
append	append.yaml
Lblproject'Coln'StatementKind'ColnColn'Assign'Coln'rvalue	Lblproject'Coln'StatementKind'ColnColn'Assign'Coln'rvalue.yaml
Lbl'UndsPipe'Int'Unds'	Lbl'UndsPipe'Int'Unds'.yaml
LblisUBPtrOffsetDiff	LblisUBPtrOffsetDiff.yaml
Lblproject'Coln'CurrentBodyCell	Lblproject'Coln'CurrentBodyCell.yaml
Lblproject'Coln'mk'LParUndsCommUndsCommUndsCommUndsRParUnds'TYPES'Unds'VariantsShapeMultiple'Unds'Scalar'Unds'TagEncoding'Unds'MIRInt'Unds'LayoutShapes'Coln'tagField	Lblproject'Coln'mk'LParUndsCommUndsCommUndsCommUndsRParUnds'TYPES'Unds'VariantsShapeMultiple'Unds'Scalar'Unds'TagEncoding'Unds'MIRInt'Unds'LayoutShapes'Coln'tagField.yaml
Lblproject'Coln'DestCellOpt	Lblproject'Coln'DestCellOpt.yaml
Lblproject'ColnHash'execTerminatorCall'LParUndsCommUndsCommUndsCommUndsCommUndsCommUndsRParUnds'KMIR-CONTROL-FLOW'Unds'KItem'Unds'Ty'Unds'MonoItemKind'Unds'Operands'Unds'Place'Unds'MaybeBasicBlockIdx'Unds'UnwindAction'Coln'unwind	Lblproject'ColnHash'execTerminatorCall'LParUndsCommUndsCommUndsCommUndsCommUndsCommUndsRParUnds'KMIR-CONTROL-FLOW'Unds'KItem'Unds'Ty'Unds'MonoItemKind'Unds'Operands'Unds'Place'Unds'MaybeBasicBlockIdx'Unds'UnwindAction'Coln'unwind.yaml
Lbl'Unds'andThenBool'Unds'	Lbl'Unds'andThenBool'Unds'.yaml
LblInt2BytesNoLen	LblInt2BytesNoLen.yaml
LblisFieldsShape	LblisFieldsShape.yaml
Lbl'Hash'alignOf'LParUndsRParUnds'RT-TYPES'Unds'Int'Unds'TypeInfo	Lbl'Hash'alignOf'LParUndsRParUnds'RT-TYPES'Unds'Int'Unds'TypeInfo.yaml
Lblproject'Coln'TypeMappings	Lblproject'Coln'TypeMappings.yaml
Lblproject'Coln'localDecl'LParUndsCommUndsCommUndsRParUnds'BODY'Unds'LocalDecl'Unds'Ty'Unds'Span'Unds'Mutability'Coln'ty	Lblproject'Coln'localDecl'LParUndsCommUndsCommUndsRParUnds'BODY'Unds'LocalDecl'Unds'Ty'Unds'Span'Unds'Mutability'Coln'ty.yaml
LbllookupTy4	LbllookupTy4.yaml
LblatanFloat'LParUndsRParUnds'FLOAT'Unds'Float'Unds'Float	LblatanFloat'LParUndsRParUnds'FLOAT'Unds'Float'Unds'Float.yaml
LblisAbi	LblisAbi.yaml
Lblproject'Coln'switchTargets'LParUndsCommUndsRParUnds'BODY'Unds'SwitchTargets'Unds'Branches'Unds'BasicBlockIdx'Coln'branches	Lblproject'Coln'switchTargets'LParUndsCommUndsRParUnds'BODY'Unds'SwitchTargets'Unds'Branches'Unds'BasicBlockIdx'Coln'branches.yaml
Lblproject'Coln'TerminatorKind'ColnColn'InlineAsm'Coln'operands	Lblproject'Coln'TerminatorKind'ColnColn'InlineAsm'Coln'operands.yaml
Lblproject'Coln'paramTy'LParUndsCommUndsRParUnds'TYPES'Unds'ParamTy'Unds'MIRInt'Unds'MIRString'Coln'index	Lblproject'Coln'paramTy'LParUndsCommUndsRParUnds'TYPES'Unds'ParamTy'Unds'MIRInt'Unds'MIRString'Coln'index.yaml
Lblproject'Coln'sourceInfo'LParUndsCommUndsRParUnds'BODY'Unds'SourceInfo'Unds'Span'Unds'SourceScope'Coln'scope	Lblproject'Coln'sourceInfo'LParUndsCommUndsRParUnds'BODY'Unds'SourceInfo'Unds'Span'Unds'SourceScope'Coln'scope.yaml
Lbl'Hash'decodeFieldsWithOffsets'LParUndsCommUndsCommUndsRParUnds'RT-DECODING'Unds'List'Unds'Bytes'Unds'Tys'Unds'MachineSizes	Lbl'Hash'decodeFieldsWithOffsets'LParUndsCommUndsCommUndsRParUnds'RT-DECODING'Unds'List'Unds'Bytes'Unds'Tys'Unds'MachineSizes.yaml
Lblproject'Coln'TerminatorKind'ColnColn'InlineAsm'Coln'lineSpans	Lblproject'Coln'TerminatorKind'ColnColn'InlineAsm'Coln'lineSpans.yaml
Lblproject'Coln'existentialProjection'LParUndsCommUndsCommUndsRParUnds'TYPES'Unds'ExistentialProjection'Unds'TraitDef'Unds'GenericArgs'Unds'TermKind'Coln'term	Lblproject'Coln'existentialProjection'LParUndsCommUndsCommUndsRParUnds'TYPES'Unds'ExistentialProjection'Unds'TraitDef'Unds'GenericArgs'Unds'TermKind'Coln'term.yaml
Lblproject'Coln'VariantAndFieldIndex	Lblproject'Coln'VariantAndFieldIndex.yaml
LblisAssertMessage	LblisAssertMessage.yaml
Lblproject'Coln'ValueAbiAggregate	Lblproject'Coln'ValueAbiAggregate.yaml
Lblproject'Coln'userTypeProjection'LParUndsCommUndsRParUnds'BODY'Unds'UserTypeProjection'Unds'UserTypeAnnotationIndex'Unds'Opaque'Coln'base	Lblproject'Coln'userTypeProjection'LParUndsCommUndsRParUnds'BODY'Unds'UserTypeProjection'Unds'UserTypeAnnotationIndex'Unds'Opaque'Coln'base.yaml
LblisParamConst	LblisParamConst.yaml
LblisTypeAndMut	LblisTypeAndMut.yaml
Lblproject'Coln'MaybeUserTypeAnnotationIndex	Lblproject'Coln'MaybeUserTypeAnnotationIndex.yaml
LbllookupTy3	LbllookupTy3.yaml
Lbl'UndsEqlsSlshEqls'Int'Unds'	Lbl'UndsEqlsSlshEqls'Int'Unds'.yaml
Lblproject'Coln'fnAbi'LParUndsCommUndsCommUndsCommUndsCommUndsRParUnds'ABI'Unds'FnAbi'Unds'ArgAbis'Unds'ArgAbi'Unds'MIRInt'Unds'CallConvention'Unds'MIRBool'Coln'fixedCount	Lblproject'Coln'fnAbi'LParUndsCommUndsCommUndsCommUndsCommUndsRParUnds'ABI'Unds'FnAbi'Unds'ArgAbis'Unds'ArgAbi'Unds'MIRInt'Unds'CallConvention'Unds'MIRBool'Coln'fixedCount.yaml
Lbl'Unds'orBool'Unds'	Lbl'Unds'orBool'Unds'.yaml
LblisSafety	LblisSafety.yaml
Lblproject'Coln'FnDef	Lblproject'Coln'FnDef.yaml
LblisConstantKind	LblisConstantKind.yaml
LblisBoundVar	LblisBoundVar.yaml
LblisSpan	LblisSpan.yaml
Lbl'Unds'-Int'Unds'	Lbl'Unds'-Int'Unds'.yaml
Lblproject'Coln'AssertMessage'ColnColn'BoundsCheck'Coln'len	Lblproject'Coln'AssertMessage'ColnColn'BoundsCheck'Coln'len.yaml
Lblproject'Coln'predicateKindAndSpanPair'LParUndsCommUndsRParUnds'TYPES'Unds'PredicateKindAndSpanPair'Unds'PredicateKind'Unds'Span'Coln'predicateKind	Lblproject'Coln'predicateKindAndSpanPair'LParUndsCommUndsRParUnds'TYPES'Unds'PredicateKindAndSpanPair'Unds'PredicateKind'Unds'Span'Coln'predicateKind.yaml
LblisBool	LblisBool.yaml
Lblproject'Coln'TyConstId	Lblproject'Coln'TyConstId.yaml
LblisGlobalAlloc	LblisGlobalAlloc.yaml
LblisBreakOnFunctionsCell	LblisBreakOnFunctionsCell.yaml
LblisRegion	LblisRegion.yaml
Lblproject'Coln'MIRBytes	Lblproject'Coln'MIRBytes.yaml
LbltyOfLocal'LParUndsRParUnds'RT-VALUE-SYNTAX'Unds'Ty'Unds'TypedLocal	LbltyOfLocal'LParUndsRParUnds'RT-VALUE-SYNTAX'Unds'Ty'Unds'TypedLocal.yaml
Lblproject'Coln'Contexts	Lblproject'Coln'Contexts.yaml
LblisFilename	LblisFilename.yaml
Lblproject'Coln'patternRange'LParUndsCommUndsCommUndsRParUnds'TYPES'Unds'Pattern'Unds'MaybeTyConst'Unds'MaybeTyConst'Unds'MIRBool'Coln'includeEnd	Lblproject'Coln'patternRange'LParUndsCommUndsCommUndsRParUnds'TYPES'Unds'Pattern'Unds'MaybeTyConst'Unds'MaybeTyConst'Unds'MIRBool'Coln'includeEnd.yaml
Lblproject'Coln'Endianness	Lblproject'Coln'Endianness.yaml
Lblproject'Coln'variantDef'LParUndsCommUndsRParUnds'TYPES'Unds'VariantDef'Unds'VariantIdx'Unds'AdtDef'Coln'idx	Lblproject'Coln'variantDef'LParUndsCommUndsRParUnds'TYPES'Unds'VariantDef'Unds'VariantIdx'Unds'AdtDef'Coln'idx.yaml
LblfindString'LParUndsCommUndsCommUndsRParUnds'STRING-COMMON'Unds'Int'Unds'String'Unds'String'Unds'Int	LblfindString'LParUndsCommUndsCommUndsRParUnds'STRING-COMMON'Unds'Int'Unds'String'Unds'String'Unds'Int.yaml
Lblproject'Coln'crate'LParUndsCommUndsCommUndsRParUnds'LIB'Unds'Crate'Unds'CrateNum'Unds'Symbol'Unds'MIRBool'Coln'id	Lblproject'Coln'crate'LParUndsCommUndsCommUndsRParUnds'LIB'Unds'Crate'Unds'CrateNum'Unds'Symbol'Unds'MIRBool'Coln'id.yaml
Lblproject'Coln'K	Lblproject'Coln'K.yaml
Lblproject'Coln'constOperand'LParUndsCommUndsCommUndsRParUnds'BODY'Unds'ConstOperand'Unds'Span'Unds'MaybeUserTypeAnnotationIndex'Unds'MirConst'Coln'span	Lblproject'Coln'constOperand'LParUndsCommUndsCommUndsRParUnds'BODY'Unds'ConstOperand'Unds'Span'Unds'MaybeUserTypeAnnotationIndex'Unds'MirConst'Coln'span.yaml
Lbl'Hash'metadataSize'LParUndsRParUnds'RT-TYPES'Unds'MetadataSize'Unds'MaybeTy	Lbl'Hash'metadataSize'LParUndsRParUnds'RT-TYPES'Unds'MetadataSize'Unds'MaybeTy.yaml
LblremoveAll'LParUndsCommUndsRParUnds'MAP'Unds'Map'Unds'Map'Unds'Set	LblremoveAll'LParUndsCommUndsRParUnds'MAP'Unds'Map'Unds'Map'Unds'Set.yaml
Lblproject'Coln'BinOp	Lblproject'Coln'BinOp.yaml
Lblproject'Coln'terminator'LParUndsCommUndsRParUnds'BODY'Unds'Terminator'Unds'TerminatorKind'Unds'Span'Coln'span	Lblproject'Coln'terminator'LParUndsCommUndsRParUnds'BODY'Unds'Terminator'Unds'TerminatorKind'Unds'Span'Coln'span.yaml
Lblproject'Coln'MachineSize'ColnColn'num'Unds'bits'Coln'numBits	Lblproject'Coln'MachineSize'ColnColn'num'Unds'bits'Coln'numBits.yaml
Lblproject'Coln'Set	Lblproject'Coln'Set.yaml
Lblproject'Coln'allocation'Coln'mutability	Lblproject'Coln'allocation'Coln'mutability.yaml
Lbl--Float'UndsUnds'FLOAT'Unds'Float'Unds'Float	Lbl--Float'UndsUnds'FLOAT'Unds'Float'Unds'Float.yaml
LblrefToPtrLocal'LParUndsCommUndsRParUnds'RT-DATA'Unds'Value'Unds'Value'Unds'Mutability	LblrefToPtrLocal'LParUndsCommUndsRParUnds'RT-DATA'Unds'Value'Unds'Value'Unds'Mutability.yaml
Lblproject'Coln'CoroutineSource	Lblproject'Coln'CoroutineSource.yaml
Lbl'Unds'orElseBool'Unds'	Lbl'Unds'orElseBool'Unds'.yaml
Lblproject'Coln'MonoItem	Lblproject'Coln'MonoItem.yaml
LblisPolyFnSig	LblisPolyFnSig.yaml
Lblproject'Coln'CastKind	Lblproject'Coln'CastKind.yaml
Lblproject'Coln'AddressSpace	Lblproject'Coln'AddressSpace.yaml
Lblproject'Coln'TypeInfo'ColnColn'TupleType'Coln'types	Lblproject'Coln'TypeInfo'ColnColn'TupleType'Coln'types.yaml
LblisPgm	LblisPgm.yaml
Lblproject'Coln'Rvalue'ColnColn'ThreadLocalRef'Coln'crate	Lblproject'Coln'Rvalue'ColnColn'ThreadLocalRef'Coln'crate.yaml
Lblproject'Coln'ProjectionElem'ColnColn'Subslice'Coln'to	Lblproject'Coln'ProjectionElem'ColnColn'Subslice'Coln'to.yaml
Lblproject'Coln'body'LParUndsCommUndsCommUndsCommUndsCommUndsCommUndsRParUnds'BODY'Unds'Body'Unds'BasicBlocks'Unds'LocalDecls'Unds'MIRInt'Unds'VarDebugInfos'Unds'MaybeLocal'Unds'Span'Coln'locals	Lblproject'Coln'body'LParUndsCommUndsCommUndsCommUndsCommUndsCommUndsRParUnds'BODY'Unds'Body'Unds'BasicBlocks'Unds'LocalDecls'Unds'MIRInt'Unds'VarDebugInfos'Unds'MaybeLocal'Unds'Span'Coln'locals.yaml
Lblproject'Coln'StatementKind'ColnColn'AscribeUserType'Coln'projections	Lblproject'Coln'StatementKind'ColnColn'AscribeUserType'Coln'projections.yaml
Lblproject'Coln'place'Coln'local	Lblproject'Coln'place'Coln'local.yaml
Lblproject'Coln'SourceScope	Lblproject'Coln'SourceScope.yaml
LblisBinderForFnSig	LblisBinderForFnSig.yaml
LblisPlaceholderForBoundRegion	LblisPlaceholderForBoundRegion.yaml
LblisExistentialPredicateBinder	LblisExistentialPredicateBinder.yaml
Lblproject'Coln'ProvenanceMapEntries	Lblproject'Coln'ProvenanceMapEntries.yaml
Lblproject'Coln'TagEncoding	Lblproject'Coln'TagEncoding.yaml
LbldecodeValue	LbldecodeValue.yaml
Lblproject'Coln'TerminatorKind'ColnColn'Assert'Coln'expected	Lblproject'Coln'TerminatorKind'ColnColn'Assert'Coln'expected.yaml
Lblproject'Coln'CurrentBodyCellOpt	Lblproject'Coln'CurrentBodyCellOpt.yaml
Lblproject'Coln'NonDivergingIntrinsic	Lblproject'Coln'NonDivergingIntrinsic.yaml
Lbl'Hash'staticArrayLenBits'LParUndsRParUnds'RT-DATA'Unds'Int'Unds'TypeInfo	Lbl'Hash'staticArrayLenBits'LParUndsRParUnds'RT-DATA'Unds'Int'Unds'TypeInfo.yaml
Lblproject'Coln'ParamTy	Lblproject'Coln'ParamTy.yaml
LblisMaybeLayoutShape	LblisMaybeLayoutShape.yaml
Lblproject'Coln'inlineAsmOperand'LParUndsCommUndsCommUndsRParUnds'BODY'Unds'InlineAsmOperand'Unds'MaybeOperand'Unds'MaybePlace'Unds'MIRString'Coln'inValue	Lblproject'Coln'inlineAsmOperand'LParUndsCommUndsCommUndsRParUnds'BODY'Unds'InlineAsmOperand'Unds'MaybeOperand'Unds'MaybePlace'Unds'MIRString'Coln'inValue.yaml
LblisPredicateKind	LblisPredicateKind.yaml
Lblproject'Coln'typeAndMut'LParUndsCommUndsRParUnds'TYPES'Unds'TypeAndMut'Unds'Ty'Unds'Mutability'Coln'mutability	Lblproject'Coln'typeAndMut'LParUndsCommUndsRParUnds'TYPES'Unds'TypeAndMut'Unds'Ty'Unds'Mutability'Coln'mutability.yaml
LblBool2String'LParUndsRParUnds'STRING-COMMON'Unds'String'Unds'Bool	LblBool2String'LParUndsRParUnds'STRING-COMMON'Unds'String'Unds'Bool.yaml
LblmutabilityOf'LParUndsRParUnds'RT-VALUE-SYNTAX'Unds'Mutability'Unds'TypedLocal	LblmutabilityOf'LParUndsRParUnds'RT-VALUE-SYNTAX'Unds'Mutability'Unds'TypedLocal.yaml
LblisNaN'LParUndsRParUnds'FLOAT'Unds'Bool'Unds'Float	LblisNaN'LParUndsRParUnds'FLOAT'Unds'Bool'Unds'Float.yaml
LblList'Coln'get	LblList'Coln'get.yaml
LblisPrimitiveType	LblisPrimitiveType.yaml
Lbl'Hash'littleEndianFromBytes'LParUndsRParUnds'RT-DATA'Unds'Int'Unds'List	Lbl'Hash'littleEndianFromBytes'LParUndsRParUnds'RT-DATA'Unds'Int'Unds'List.yaml
Lblproject'Coln'genericPredicates'LParUndsCommUndsRParUnds'TYPES'Unds'GenericPredicates'Unds'MaybeTraitDef'Unds'PredicateKindAndSpanPairs'Coln'predicates	Lblproject'Coln'genericPredicates'LParUndsCommUndsRParUnds'TYPES'Unds'GenericPredicates'Unds'MaybeTraitDef'Unds'PredicateKindAndSpanPairs'Coln'predicates.yaml
LblisGenericDefAndIdxPairs	LblisGenericDefAndIdxPairs.yaml
LblonInt'LParUndsCommUndsCommUndsRParUnds'RT-DATA'Unds'Int'Unds'BinOp'Unds'Int'Unds'Int	LblonInt'LParUndsCommUndsCommUndsRParUnds'RT-DATA'Unds'Int'Unds'BinOp'Unds'Int'Unds'Int.yaml
Lblproject'Coln'varDebugInfoFragment'LParUndsCommUndsRParUnds'BODY'Unds'VarDebugInfoFragment'Unds'Ty'Unds'ProjectionElems'Coln'ty	Lblproject'Coln'varDebugInfoFragment'LParUndsCommUndsRParUnds'BODY'Unds'VarDebugInfoFragment'Unds'Ty'Unds'ProjectionElems'Coln'ty.yaml
Lblproject'Coln'VarDebugInfos	Lblproject'Coln'VarDebugInfos.yaml
Lblproject'Coln'UBPtrOffsetDiff	Lblproject'Coln'UBPtrOffsetDiff.yaml
Lblproject'Coln'traitDecl'LParUndsCommUndsCommUndsCommUndsCommUndsCommUndsCommUndsCommUndsCommUndsCommUndsCommUndsRParUnds'TYPES'Unds'TraitDecl'Unds'TraitDef'Unds'Safety'Unds'MIRBool'Unds'MIRBool'Unds'MIRBool'Unds'MIRBool'Unds'MIRBool'Unds'TraitSpecializationKind'Unds'MaybeIdents'Unds'MIRBool'Unds'MIRBool'Coln'unsafety	Lblproject'Coln'traitDecl'LParUndsCommUndsCommUndsCommUndsCommUndsCommUndsCommUndsCommUndsCommUndsCommUndsCommUndsRParUnds'TYPES'Unds'TraitDecl'Unds'TraitDef'Unds'Safety'Unds'MIRBool'Unds'MIRBool'Unds'MIRBool'Unds'MIRBool'Unds'MIRBool'Unds'710.yaml
Lblproject'Coln'lineInfo'LParUndsCommUndsCommUndsCommUndsRParUnds'TYPES'Unds'LineInfo'Unds'MIRInt'Unds'MIRInt'Unds'MIRInt'Unds'MIRInt'Coln'startLine	Lblproject'Coln'lineInfo'LParUndsCommUndsCommUndsCommUndsRParUnds'TYPES'Unds'LineInfo'Unds'MIRInt'Unds'MIRInt'Unds'MIRInt'Unds'MIRInt'Coln'startLine.yaml
LblinitBreakOnFunctionsCell	LblinitBreakOnFunctionsCell.yaml
LblgetFieldTyFromList'LParUndsCommUndsRParUnds'RT-TYPES'Unds'MaybeTy'Unds'Tys'Unds'Int	LblgetFieldTyFromList'LParUndsCommUndsRParUnds'RT-TYPES'Unds'MaybeTy'Unds'Tys'Unds'Int.yaml
LblpointeeTy'LParUndsRParUnds'RT-TYPES'Unds'MaybeTy'Unds'TypeInfo	LblpointeeTy'LParUndsRParUnds'RT-TYPES'Unds'MaybeTy'Unds'TypeInfo.yaml
Lblproject'Coln'UnwindAction	Lblproject'Coln'UnwindAction.yaml
LblsqrtFloat'LParUndsRParUnds'FLOAT'Unds'Float'Unds'Float	LblsqrtFloat'LParUndsRParUnds'FLOAT'Unds'Float'Unds'Float.yaml
Lblproject'Coln'provenanceMap'Coln'ptrs	Lblproject'Coln'provenanceMap'Coln'ptrs.yaml
LblrfindString'LParUndsCommUndsCommUndsRParUnds'STRING-COMMON'Unds'Int'Unds'String'Unds'String'Unds'Int	LblrfindString'LParUndsCommUndsCommUndsRParUnds'STRING-COMMON'Unds'Int'Unds'String'Unds'String'Unds'Int.yaml
LblisStackCell	LblisStackCell.yaml
LblisMirConstId	LblisMirConstId.yaml
Lbl'Hash'areLittleEndianBytes'LParUndsRParUnds'RT-DATA'Unds'Bool'Unds'List	Lbl'Hash'areLittleEndianBytes'LParUndsRParUnds'RT-DATA'Unds'Bool'Unds'List.yaml
Lblproject'Coln'allocation'Coln'align	Lblproject'Coln'allocation'Coln'align.yaml
LblisStatements	LblisStatements.yaml
Lbl'Unds'divInt'Unds'	Lbl'Unds'divInt'Unds'.yaml
Lbl'Hash'validDiscriminantAux'LParUndsCommUndsRParUnds'RT-DATA'Unds'Bool'Unds'Int'Unds'Discriminants	Lbl'Hash'validDiscriminantAux'LParUndsCommUndsRParUnds'RT-DATA'Unds'Bool'Unds'Int'Unds'Discriminants.yaml
LblisTraitRef	LblisTraitRef.yaml
Lblproject'Coln'unevaluatedConst'LParUndsCommUndsCommUndsRParUnds'TYPES'Unds'UnevaluatedConst'Unds'ConstDef'Unds'GenericArgs'Unds'MaybePromoted'Coln'promoted	Lblproject'Coln'unevaluatedConst'LParUndsCommUndsCommUndsRParUnds'TYPES'Unds'UnevaluatedConst'Unds'ConstDef'Unds'GenericArgs'Unds'MaybePromoted'Coln'promoted.yaml
Lblproject'Coln'ProjectionElem'ColnColn'Subslice'Coln'fromEnd	Lblproject'Coln'ProjectionElem'ColnColn'Subslice'Coln'fromEnd.yaml
LblisCrateNum	LblisCrateNum.yaml
Lblproject'Coln'MonoItemKind	Lblproject'Coln'MonoItemKind.yaml
LblisTy	LblisTy.yaml
LblgetGeneratedCounterCell	LblgetGeneratedCounterCell.yaml
LblisKmirCellOpt	LblisKmirCellOpt.yaml
Lblproject'Coln'Span	Lblproject'Coln'Span.yaml
Lbl'Stop'Set	Lbl'Stop'Set.yaml
Lblproject'Coln'GenericParamDefKind'ColnColn'Type'Coln'synthetic	Lblproject'Coln'GenericParamDefKind'ColnColn'Type'Coln'synthetic.yaml
Lblproject'Coln'TypeInfo'ColnColn'UnionType'Coln'name	Lblproject'Coln'TypeInfo'ColnColn'UnionType'Coln'name.yaml
LblisBorrowKind	LblisBorrowKind.yaml
Lblproject'Coln'SubtypePredicate	Lblproject'Coln'SubtypePredicate.yaml
Lblproject'Coln'VariantDef	Lblproject'Coln'VariantDef.yaml
LblSet'Coln'difference	LblSet'Coln'difference.yaml
Lblproject'Coln'layoutShape'LParUndsCommUndsCommUndsCommUndsCommUndsRParUnds'TYPES'Unds'LayoutShape'Unds'FieldsShape'Unds'VariantsShape'Unds'ValueAbi'Unds'Align'Unds'MachineSize'Coln'size	Lblproject'Coln'layoutShape'LParUndsCommUndsCommUndsCommUndsCommUndsRParUnds'TYPES'Unds'LayoutShape'Unds'FieldsShape'Unds'VariantsShape'Unds'ValueAbi'Unds'Align'Unds'MachineSize'Coln'size.yaml
LblisEvaluation	LblisEvaluation.yaml
LblisFloat	LblisFloat.yaml
Lblproject'Coln'ProjectionElem'ColnColn'Subslice'Coln'from	Lblproject'Coln'ProjectionElem'ColnColn'Subslice'Coln'from.yaml
Lbl'Hash'functionNameMatchesAnyList'LParUndsCommUndsRParUnds'KMIR-CONTROL-FLOW'Unds'Bool'Unds'String'Unds'List	Lbl'Hash'functionNameMatchesAnyList'LParUndsCommUndsRParUnds'KMIR-CONTROL-FLOW'Unds'Bool'Unds'String'Unds'List.yaml
LblisForeignItemKind	LblisForeignItemKind.yaml
LblInt2Bytes'LParUndsCommUndsCommUndsRParUnds'BYTES-HOOKED'Unds'Bytes'Unds'Int'Unds'Int'Unds'Endianness	LblInt2Bytes'LParUndsCommUndsCommUndsRParUnds'BYTES-HOOKED'Unds'Bytes'Unds'Int'Unds'Int'Unds'Endianness.yaml
LblisAlign	LblisAlign.yaml
Lblproject'Coln'BinderForFnSig	Lblproject'Coln'BinderForFnSig.yaml
Lblproject'Coln'TypeInfo'ColnColn'EnumType'Coln'discriminants	Lblproject'Coln'TypeInfo'ColnColn'EnumType'Coln'discriminants.yaml
Lblproject'Coln'ValueAbi	Lblproject'Coln'ValueAbi.yaml
Lblproject'Coln'TerminatorKind'ColnColn'Call'Coln'unwind	Lblproject'Coln'TerminatorKind'ColnColn'Call'Coln'unwind.yaml
LblisCopyNonOverlapping	LblisCopyNonOverlapping.yaml
Lblproject'Coln'StackFrame'LParUndsCommUndsCommUndsCommUndsCommUndsRParUnds'KMIR-CONFIGURATION'Unds'StackFrame'Unds'Ty'Unds'Place'Unds'MaybeBasicBlockIdx'Unds'UnwindAction'Unds'List'Coln'locals	Lblproject'Coln'StackFrame'LParUndsCommUndsCommUndsCommUndsCommUndsRParUnds'KMIR-CONFIGURATION'Unds'StackFrame'Unds'Ty'Unds'Place'Unds'MaybeBasicBlockIdx'Unds'UnwindAction'Unds'List'Coln'locals.yaml
Lblproject'Coln'mk'LParUndsCommUndsRParUnds'TYPES'Unds'ScalarInitialized'Unds'Primitive'Unds'WrappingRange'Coln'validRange	Lblproject'Coln'mk'LParUndsCommUndsRParUnds'TYPES'Unds'ScalarInitialized'Unds'Primitive'Unds'WrappingRange'Coln'validRange.yaml
Lblproject'Coln'mk'LParUndsRParUnds'TYPES'Unds'FieldsShapeArbitrary'Unds'MachineSizes'Coln'offsets	Lblproject'Coln'mk'LParUndsRParUnds'TYPES'Unds'FieldsShapeArbitrary'Unds'MachineSizes'Coln'offsets.yaml
LblisLocal	LblisLocal.yaml
Lblproject'Coln'TerminatorKind'ColnColn'InlineAsm'Coln'destination	Lblproject'Coln'TerminatorKind'ColnColn'InlineAsm'Coln'destination.yaml
LblisValue	LblisValue.yaml
Lbl'Hash'decodeSliceAllocation'LParUndsCommUndsRParUnds'RT-DECODING'Unds'Value'Unds'Bytes'Unds'TypeInfo	Lbl'Hash'decodeSliceAllocation'LParUndsCommUndsRParUnds'RT-DECODING'Unds'Value'Unds'Bytes'Unds'TypeInfo.yaml
LblgetArrayElemTy'LParUndsRParUnds'RT-TYPES'Unds'Ty'Unds'TypeInfo	LblgetArrayElemTy'LParUndsRParUnds'RT-TYPES'Unds'Ty'Unds'TypeInfo.yaml
LblisPredicateKindAndSpanPair	LblisPredicateKindAndSpanPair.yaml
LblisVariantAndFieldIndex	LblisVariantAndFieldIndex.yaml
LblisInlineAsmOperands	LblisInlineAsmOperands.yaml
Lblproject'Coln'List	Lblproject'Coln'List.yaml
LblisCastKind	LblisCastKind.yaml
Lblproject'Coln'Abi	Lblproject'Coln'Abi.yaml
LblisK	LblisK.yaml
Lblproject'Coln'StatementKind'ColnColn'Retag'Coln'place	Lblproject'Coln'StatementKind'ColnColn'Retag'Coln'place.yaml
LblisMonoItems	LblisMonoItems.yaml
Lblproject'Coln'UserTypeAnnotationIndex	Lblproject'Coln'UserTypeAnnotationIndex.yaml
Lblproject'Coln'ClosureKind	Lblproject'Coln'ClosureKind.yaml
Lblproject'Coln'fieldDef'LParUndsCommUndsRParUnds'TYPES'Unds'FieldDef'Unds'DefId'Unds'Symbol'Coln'def	Lblproject'Coln'fieldDef'LParUndsCommUndsRParUnds'TYPES'Unds'FieldDef'Unds'DefId'Unds'Symbol'Coln'def.yaml
Lblproject'Coln'ExistentialProjection	Lblproject'Coln'ExistentialProjection.yaml
LbllengthBytes'LParUndsRParUnds'BYTES-HOOKED'Unds'Int'Unds'Bytes	LbllengthBytes'LParUndsRParUnds'BYTES-HOOKED'Unds'Int'Unds'Bytes.yaml
LblisFunctionNames	LblisFunctionNames.yaml
Lbl'Hash'layoutOffsets'LParUndsRParUnds'RT-TYPES'Unds'MachineSizes'Unds'MaybeLayoutShape	Lbl'Hash'layoutOffsets'LParUndsRParUnds'RT-TYPES'Unds'MachineSizes'Unds'MaybeLayoutShape.yaml
Lbl'Hash'littleEndianBytes'LParUndsCommUndsRParUnds'RT-DATA'Unds'List'Unds'Int'Unds'Int	Lbl'Hash'littleEndianBytes'LParUndsCommUndsRParUnds'RT-DATA'Unds'List'Unds'Int'Unds'Int.yaml
Lblproject'Coln'ProjectionElem'ColnColn'ConstantIndex'Coln'fromEnd	Lblproject'Coln'ProjectionElem'ColnColn'ConstantIndex'Coln'fromEnd.yaml
Lblproject'Coln'StaticDef	Lblproject'Coln'StaticDef.yaml
LblisPlace	LblisPlace.yaml
Lblproject'Coln'Value	Lblproject'Coln'Value.yaml
Lbl'Unds-GT--GT-'Int'Unds'	Lbl'Unds-GT--GT-'Int'Unds'.yaml
Lblproject'Coln'TerminatorKind	Lblproject'Coln'TerminatorKind.yaml
Lbl'Hash'sizeOf'LParUndsRParUnds'RT-TYPES'Unds'Int'Unds'TypeInfo	Lbl'Hash'sizeOf'LParUndsRParUnds'RT-TYPES'Unds'Int'Unds'TypeInfo.yaml
Lblproject'Coln'foreignModule'LParUndsCommUndsRParUnds'TYPES'Unds'ForeignModule'Unds'ForeignModuleDef'Unds'Abi'Coln'abi	Lblproject'Coln'foreignModule'LParUndsCommUndsRParUnds'TYPES'Unds'ForeignModule'Unds'ForeignModuleDef'Unds'Abi'Coln'abi.yaml
Lblproject'Coln'Layout	Lblproject'Coln'Layout.yaml
LblisCoroutineDef	LblisCoroutineDef.yaml
LblisMaybeTraitDef	LblisMaybeTraitDef.yaml
LblisAggregateKind	LblisAggregateKind.yaml
LblisMaybeBody	LblisMaybeBody.yaml
Lblproject'Coln'AssertMessage'ColnColn'MisalignedPointerDereference'Coln'required	Lblproject'Coln'AssertMessage'ColnColn'MisalignedPointerDereference'Coln'required.yaml
Lblproject'Coln'fnAbi'LParUndsCommUndsCommUndsCommUndsCommUndsRParUnds'ABI'Unds'FnAbi'Unds'ArgAbis'Unds'ArgAbi'Unds'MIRInt'Unds'CallConvention'Unds'MIRBool'Coln'ret	Lblproject'Coln'fnAbi'LParUndsCommUndsCommUndsCommUndsCommUndsRParUnds'ABI'Unds'FnAbi'Unds'ArgAbis'Unds'ArgAbi'Unds'MIRInt'Unds'CallConvention'Unds'MIRBool'Coln'ret.yaml
LbllookupTy	LbllookupTy.yaml
LblisVariantIdx	LblisVariantIdx.yaml
Lblproject'Coln'Discriminants	Lblproject'Coln'Discriminants.yaml
LblisString	LblisString.yaml
Lblproject'Coln'TyConst	Lblproject'Coln'TyConst.yaml
Lblproject'Coln'VariantsShape	Lblproject'Coln'VariantsShape.yaml
LblisPredicateKindAndSpanPairs	LblisPredicateKindAndSpanPairs.yaml
LblisGenericDef	LblisGenericDef.yaml
Lblsize'LParUndsRParUnds'SET'Unds'Int'Unds'Set	Lblsize'LParUndsRParUnds'SET'Unds'Int'Unds'Set.yaml
Lblproject'Coln'GenericParamDefKind'ColnColn'Type'Coln'hasDefault	Lblproject'Coln'GenericParamDefKind'ColnColn'Type'Coln'hasDefault.yaml
Lblproject'Coln'genericParamDef'LParUndsCommUndsCommUndsCommUndsCommUndsRParUnds'TYPES'Unds'GenericParamDef'Unds'Symbol'Unds'GenericDef'Unds'MIRInt'Unds'MIRBool'Unds'GenericParamDefKind'Coln'defId	Lblproject'Coln'genericParamDef'LParUndsCommUndsCommUndsCommUndsCommUndsRParUnds'TYPES'Unds'GenericParamDef'Unds'Symbol'Unds'GenericDef'Unds'MIRInt'Unds'MIRBool'Unds'GenericParamDefKind'Coln'defId.yaml
LblisDestCellOpt	LblisDestCellOpt.yaml
Lblproject'Coln'GenericPredicates	Lblproject'Coln'GenericPredicates.yaml
Lblproject'Coln'BasicBlock	Lblproject'Coln'BasicBlock.yaml
Lblproject'Coln'PredicatePolarity	Lblproject'Coln'PredicatePolarity.yaml
Lblproject'Coln'CoroutineWitnessDef	Lblproject'Coln'CoroutineWitnessDef.yaml
LblintersectSet'LParUndsCommUndsRParUnds'SET'Unds'Set'Unds'Set'Unds'Set	LblintersectSet'LParUndsCommUndsRParUnds'SET'Unds'Set'Unds'Set'Unds'Set.yaml
Lbl'Unds-LT-'String'UndsUnds'STRING-COMMON'Unds'Bool'Unds'String'Unds'String	Lbl'Unds-LT-'String'UndsUnds'STRING-COMMON'Unds'Bool'Unds'String'Unds'String.yaml
LblisClosureKind	LblisClosureKind.yaml
LbllookupAlloc3	LbllookupAlloc3.yaml
Lblproject'Coln'crate'LParUndsCommUndsCommUndsRParUnds'LIB'Unds'Crate'Unds'CrateNum'Unds'Symbol'Unds'MIRBool'Coln'name	Lblproject'Coln'crate'LParUndsCommUndsCommUndsRParUnds'LIB'Unds'Crate'Unds'CrateNum'Unds'Symbol'Unds'MIRBool'Coln'name.yaml
Lbl'Unds-LT-'Float'UndsUnds'FLOAT'Unds'Bool'Unds'Float'Unds'Float	Lbl'Unds-LT-'Float'UndsUnds'FLOAT'Unds'Bool'Unds'Float'Unds'Float.yaml
LblisAddressSpace	LblisAddressSpace.yaml
Lbl'Hash'reserveFor'LParUndsRParUnds'KMIR-CONTROL-FLOW'Unds'List'Unds'LocalDecls	Lbl'Hash'reserveFor'LParUndsRParUnds'KMIR-CONTROL-FLOW'Unds'List'Unds'LocalDecls.yaml
Lblproject'Coln'MaybeBody	Lblproject'Coln'MaybeBody.yaml
Lbl'Hash'intAsType'LParUndsCommUndsCommUndsRParUnds'RT-NUMBERS'Unds'Value'Unds'Int'Unds'Int'Unds'NumTy	Lbl'Hash'intAsType'LParUndsCommUndsCommUndsRParUnds'RT-NUMBERS'Unds'Value'Unds'Int'Unds'Int'Unds'NumTy.yaml
Lblite	Lblite.yaml
LblisScalarInitialized	LblisScalarInitialized.yaml
Lblproject'Coln'StatementKind'ColnColn'FakeRead'Coln'place	Lblproject'Coln'StatementKind'ColnColn'FakeRead'Coln'place.yaml
Lblproject'Coln'FloatTy	Lblproject'Coln'FloatTy.yaml
Lbl'Hash'decrementRef'LParUndsRParUnds'RT-DATA'Unds'Value'Unds'Value	Lbl'Hash'decrementRef'LParUndsRParUnds'RT-DATA'Unds'Value'Unds'Value.yaml
LblinitKCell	LblinitKCell.yaml
LblisProvenanceMap	LblisProvenanceMap.yaml
Lblproject'Coln'BoundTyKind	Lblproject'Coln'BoundTyKind.yaml
Lblproject'Coln'traitDecl'LParUndsCommUndsCommUndsCommUndsCommUndsCommUndsCommUndsCommUndsCommUndsCommUndsCommUndsRParUnds'TYPES'Unds'TraitDecl'Unds'TraitDef'Unds'Safety'Unds'MIRBool'Unds'MIRBool'Unds'MIRBool'Unds'MIRBool'Unds'MIRBool'Unds'TraitSpecializationKind'Unds'MaybeIdents'Unds'MIRBool'Unds'MIRBool'Coln'defId	Lblproject'Coln'traitDecl'LParUndsCommUndsCommUndsCommUndsCommUndsCommUndsCommUndsCommUndsCommUndsCommUndsCommUndsRParUnds'TYPES'Unds'TraitDecl'Unds'TraitDef'Unds'Safety'Unds'MIRBool'Unds'MIRBool'Unds'MIRBool'Unds'MIRBool'Unds'MIRBool'Unds'841.yaml
LblisCurrentFuncCell	LblisCurrentFuncCell.yaml
LblisBranches	LblisBranches.yaml
Lblproject'Coln'ParamConst	Lblproject'Coln'ParamConst.yaml
Lblproject'Coln'BreakOnFunctionsCell	Lblproject'Coln'BreakOnFunctionsCell.yaml
LblreplaceAll'LParUndsCommUndsCommUndsRParUnds'STRING-COMMON'Unds'String'Unds'String'Unds'String'Unds'String	LblreplaceAll'LParUndsCommUndsCommUndsRParUnds'STRING-COMMON'Unds'String'Unds'String'Unds'String'Unds'String.yaml
LblisMutability	LblisMutability.yaml
Lbl'Hash'decodeArrayAllocation'LParUndsCommUndsCommUndsRParUnds'RT-DECODING'Unds'Value'Unds'Bytes'Unds'TypeInfo'Unds'Int	Lbl'Hash'decodeArrayAllocation'LParUndsCommUndsCommUndsRParUnds'RT-DECODING'Unds'Value'Unds'Bytes'Unds'TypeInfo'Unds'Int.yaml
Lblproject'Coln'TypeAndMut	Lblproject'Coln'TypeAndMut.yaml
Lbl'Tild'Int'Unds'	Lbl'Tild'Int'Unds'.yaml
LblinitTargetCell	LblinitTargetCell.yaml
LblisImplPolarity	LblisImplPolarity.yaml
Lblproject'Coln'InlineAsmOperand	Lblproject'Coln'InlineAsmOperand.yaml
Lblproject'Coln'traitDecl'LParUndsCommUndsCommUndsCommUndsCommUndsCommUndsCommUndsCommUndsCommUndsCommUndsCommUndsRParUnds'TYPES'Unds'TraitDecl'Unds'TraitDef'Unds'Safety'Unds'MIRBool'Unds'MIRBool'Unds'MIRBool'Unds'MIRBool'Unds'MIRBool'Unds'TraitSpecializationKind'Unds'MaybeIdents'Unds'MIRBool'Unds'MIRBool'Coln'mustImplementOneOf	Lblproject'Coln'traitDecl'LParUndsCommUndsCommUndsCommUndsCommUndsCommUndsCommUndsCommUndsCommUndsCommUndsCommUndsRParUnds'TYPES'Unds'TraitDecl'Unds'TraitDef'Unds'Safety'Unds'MIRBool'Unds'MIRBool'Unds'MIRBool'Unds'MIRBool'Unds'MIRBool'Unds'848.yaml
LblexponentBitsFloat'LParUndsRParUnds'FLOAT'Unds'Int'Unds'Float	LblexponentBitsFloat'LParUndsRParUnds'FLOAT'Unds'Int'Unds'Float.yaml
Lblproject'Coln'InlineAsmOperands	Lblproject'Coln'InlineAsmOperands.yaml
LblisAdtDef	LblisAdtDef.yaml
Lblproject'Coln'BoundVariableKindList	Lblproject'Coln'BoundVariableKindList.yaml
LblisLineInfo	LblisLineInfo.yaml
Lbl'Hash'isArrayOf'LParUndsCommUndsRParUnds'RT-TYPES'Unds'Bool'Unds'TypeInfo'Unds'Ty	Lbl'Hash'isArrayOf'LParUndsCommUndsRParUnds'RT-TYPES'Unds'Bool'Unds'TypeInfo'Unds'Ty.yaml
Lblproject'Coln'MonoItemKind'ColnColn'MonoItemFn'Coln'name	Lblproject'Coln'MonoItemKind'ColnColn'MonoItemFn'Coln'name.yaml
Lblproject'Coln'instanceKindVirtual'LParUndsRParUnds'MONO'Unds'InstanceKind'Unds'Int'Coln'idx	Lblproject'Coln'instanceKindVirtual'LParUndsRParUnds'MONO'Unds'InstanceKind'Unds'Int'Coln'idx.yaml
Lblproject'Coln'ProjectionElem'ColnColn'ConstantIndex'Coln'minLength	Lblproject'Coln'ProjectionElem'ColnColn'ConstantIndex'Coln'minLength.yaml
Lblproject'Coln'Safety	Lblproject'Coln'Safety.yaml
LblsubstrBytes'LParUndsCommUndsCommUndsRParUnds'BYTES-HOOKED'Unds'Bytes'Unds'Bytes'Unds'Int'Unds'Int	LblsubstrBytes'LParUndsCommUndsCommUndsRParUnds'BYTES-HOOKED'Unds'Bytes'Unds'Bytes'Unds'Int'Unds'Int.yaml
Lblproject'Coln'TraitPredicate	Lblproject'Coln'TraitPredicate.yaml
LblisGenericDefAndIdxPair	LblisGenericDefAndIdxPair.yaml
LblisMaybeLocal	LblisMaybeLocal.yaml
Lblproject'Coln'StatementKind'ColnColn'SetDiscriminant'Coln'place	Lblproject'Coln'StatementKind'ColnColn'SetDiscriminant'Coln'place.yaml
Lbl'Hash'typesCompatible'LParUndsCommUndsRParUnds'RT-TYPES'Unds'Bool'Unds'TypeInfo'Unds'TypeInfo	Lbl'Hash'typesCompatible'LParUndsCommUndsRParUnds'RT-TYPES'Unds'Bool'Unds'TypeInfo'Unds'TypeInfo.yaml
Lbl'Hash'numTypeOf'LParUndsRParUnds'RT-NUMBERS'Unds'NumTy'Unds'TypeInfo	Lbl'Hash'numTypeOf'LParUndsRParUnds'RT-NUMBERS'Unds'NumTy'Unds'TypeInfo.yaml
LblisPassMode	LblisPassMode.yaml
LblmakeList'LParUndsCommUndsRParUnds'LIST'Unds'List'Unds'Int'Unds'KItem	LblmakeList'LParUndsCommUndsRParUnds'LIST'Unds'List'Unds'Int'Unds'KItem.yaml
Lblproject'Coln'Bytes	Lblproject'Coln'Bytes.yaml
Lblproject'Coln'CurrentFuncCell	Lblproject'Coln'CurrentFuncCell.yaml
Lbl'Hash'msBytes'LParUndsRParUnds'RT-DECODING'Unds'Int'Unds'MachineSize	Lbl'Hash'msBytes'LParUndsRParUnds'RT-DECODING'Unds'Int'Unds'MachineSize.yaml
Lblproject'Coln'StackFrame'LParUndsCommUndsCommUndsCommUndsCommUndsRParUnds'KMIR-CONFIGURATION'Unds'StackFrame'Unds'Ty'Unds'Place'Unds'MaybeBasicBlockIdx'Unds'UnwindAction'Unds'List'Coln'caller	Lblproject'Coln'StackFrame'LParUndsCommUndsCommUndsCommUndsCommUndsRParUnds'KMIR-CONFIGURATION'Unds'StackFrame'Unds'Ty'Unds'Place'Unds'MaybeBasicBlockIdx'Unds'UnwindAction'Unds'List'Coln'caller.yaml
Lblproject'Coln'TerminatorKind'ColnColn'Drop'Coln'unwind	Lblproject'Coln'TerminatorKind'ColnColn'Drop'Coln'unwind.yaml
Lblproject'Coln'body'LParUndsCommUndsCommUndsCommUndsCommUndsCommUndsRParUnds'BODY'Unds'Body'Unds'BasicBlocks'Unds'LocalDecls'Unds'MIRInt'Unds'VarDebugInfos'Unds'MaybeLocal'Unds'Span'Coln'varDebugInfo	Lblproject'Coln'body'LParUndsCommUndsCommUndsCommUndsCommUndsCommUndsRParUnds'BODY'Unds'Body'Unds'BasicBlocks'Unds'LocalDecls'Unds'MIRInt'Unds'VarDebugInfos'Unds'MaybeLocal'Unds'Span'Coln'varDebugInfo.yaml
LblList2Set'LParUndsRParUnds'COLLECTIONS'Unds'Set'Unds'List	LblList2Set'LParUndsRParUnds'COLLECTIONS'Unds'Set'Unds'List.yaml
LblisTypeInfo	LblisTypeInfo.yaml
Lblproject'Coln'switchTargets'LParUndsCommUndsRParUnds'BODY'Unds'SwitchTargets'Unds'Branches'Unds'BasicBlockIdx'Coln'otherwise	Lblproject'Coln'switchTargets'LParUndsCommUndsRParUnds'BODY'Unds'SwitchTargets'Unds'Branches'Unds'BasicBlockIdx'Coln'otherwise.yaml
Lblproject'Coln'TerminatorKind'ColnColn'InlineAsm'Coln'template	Lblproject'Coln'TerminatorKind'ColnColn'InlineAsm'Coln'template.yaml
Lblproject'Coln'lineInfo'LParUndsCommUndsCommUndsCommUndsRParUnds'TYPES'Unds'LineInfo'Unds'MIRInt'Unds'MIRInt'Unds'MIRInt'Unds'MIRInt'Coln'endCol	Lblproject'Coln'lineInfo'LParUndsCommUndsCommUndsCommUndsRParUnds'TYPES'Unds'LineInfo'Unds'MIRInt'Unds'MIRInt'Unds'MIRInt'Unds'MIRInt'Coln'endCol.yaml
Lblproject'Coln'StackCellOpt	Lblproject'Coln'StackCellOpt.yaml
Lblproject'Coln'statement'LParUndsCommUndsRParUnds'BODY'Unds'Statement'Unds'StatementKind'Unds'Span'Coln'kind	Lblproject'Coln'statement'LParUndsCommUndsRParUnds'BODY'Unds'Statement'Unds'StatementKind'Unds'Span'Coln'kind.yaml
LblisGeneratedTopCell	LblisGeneratedTopCell.yaml
Lbl'Hash'extractOperandType'LParUndsCommUndsRParUnds'KMIR-INTRINSICS'Unds'MaybeTy'Unds'Operand'Unds'List	Lbl'Hash'extractOperandType'LParUndsCommUndsRParUnds'KMIR-INTRINSICS'Unds'MaybeTy'Unds'Operand'Unds'List.yaml
Lblproject'Coln'layoutShape'LParUndsCommUndsCommUndsCommUndsCommUndsRParUnds'TYPES'Unds'LayoutShape'Unds'FieldsShape'Unds'VariantsShape'Unds'ValueAbi'Unds'Align'Unds'MachineSize'Coln'abi	Lblproject'Coln'layoutShape'LParUndsCommUndsCommUndsCommUndsCommUndsRParUnds'TYPES'Unds'LayoutShape'Unds'FieldsShape'Unds'VariantsShape'Unds'ValueAbi'Unds'Align'Unds'MachineSize'Coln'abi.yaml
Lblproject'Coln'InstanceKind	Lblproject'Coln'InstanceKind.yaml
Lblproject'Coln'copyNonOverlapping'LParUndsCommUndsCommUndsRParUnds'BODY'Unds'CopyNonOverlapping'Unds'Operand'Unds'Operand'Unds'Operand'Coln'src	Lblproject'Coln'copyNonOverlapping'LParUndsCommUndsCommUndsRParUnds'BODY'Unds'CopyNonOverlapping'Unds'Operand'Unds'Operand'Unds'Operand'Coln'src.yaml
LblisBytes	LblisBytes.yaml
Lbl'UndsSlsh'Int'Unds'	Lbl'UndsSlsh'Int'Unds'.yaml
Lblproject'Coln'mk'LParUndsCommUndsCommUndsCommUndsRParUnds'TYPES'Unds'VariantsShapeMultiple'Unds'Scalar'Unds'TagEncoding'Unds'MIRInt'Unds'LayoutShapes'Coln'tagEncoding	Lblproject'Coln'mk'LParUndsCommUndsCommUndsCommUndsRParUnds'TYPES'Unds'VariantsShapeMultiple'Unds'Scalar'Unds'TagEncoding'Unds'MIRInt'Unds'LayoutShapes'Coln'tagEncoding.yaml
Lblproject'Coln'region'LParUndsRParUnds'TYPES'Unds'Region'Unds'RegionKind'Coln'kind	Lblproject'Coln'region'LParUndsRParUnds'TYPES'Unds'Region'Unds'RegionKind'Coln'kind.yaml
LblisInstance	LblisInstance.yaml
Lblproject'Coln'ScalarInitialized	Lblproject'Coln'ScalarInitialized.yaml
Lblproject'Coln'constOperand'LParUndsCommUndsCommUndsRParUnds'BODY'Unds'ConstOperand'Unds'Span'Unds'MaybeUserTypeAnnotationIndex'Unds'MirConst'Coln'const	Lblproject'Coln'constOperand'LParUndsCommUndsCommUndsRParUnds'BODY'Unds'ConstOperand'Unds'Span'Unds'MaybeUserTypeAnnotationIndex'Unds'MirConst'Coln'const.yaml
Lblproject'Coln'monoItemWrapper'Coln'monoItemKind	Lblproject'Coln'monoItemWrapper'Coln'monoItemKind.yaml
Lblproject'ColnHash'execTerminatorCall'LParUndsCommUndsCommUndsCommUndsCommUndsCommUndsRParUnds'KMIR-CONTROL-FLOW'Unds'KItem'Unds'Ty'Unds'MonoItemKind'Unds'Operands'Unds'Place'Unds'MaybeBasicBlockIdx'Unds'UnwindAction'Coln'fty	Lblproject'ColnHash'execTerminatorCall'LParUndsCommUndsCommUndsCommUndsCommUndsCommUndsRParUnds'KMIR-CONTROL-FLOW'Unds'KItem'Unds'Ty'Unds'MonoItemKind'Unds'Operands'Unds'Place'Unds'MaybeBasicBlockIdx'Unds'UnwindAction'Coln'fty.yaml
Lbl'Hash'byteLength'LParUndsRParUnds'RT-DECODING'Unds'Int'Unds'IntegerLength	Lbl'Hash'byteLength'LParUndsRParUnds'RT-DECODING'Unds'Int'Unds'IntegerLength.yaml
Lblproject'Coln'ExistentialPredicateBinders	Lblproject'Coln'ExistentialPredicateBinders.yaml
LblisCallConvention	LblisCallConvention.yaml
LblabsInt'LParUndsRParUnds'INT-COMMON'Unds'Int'Unds'Int	LblabsInt'LParUndsRParUnds'INT-COMMON'Unds'Int'Unds'Int.yaml
Lblproject'Coln'UnwindCellOpt	Lblproject'Coln'UnwindCellOpt.yaml
LblisProjectionElem	LblisProjectionElem.yaml
LblinitCurrentBodyCell	LblinitCurrentBodyCell.yaml
LblcmpInt'LParUndsCommUndsRParUnds'RT-DATA'Unds'Int'Unds'Int'Unds'Int	LblcmpInt'LParUndsCommUndsRParUnds'RT-DATA'Unds'Int'Unds'Int'Unds'Int.yaml
Lblproject'Coln'Abi'ColnColn'Aapcs'Coln'unwind	Lblproject'Coln'Abi'ColnColn'Aapcs'Coln'unwind.yaml
Lblproject'Coln'TraitSpecializationKind	Lblproject'Coln'TraitSpecializationKind.yaml
LblisRetVal	LblisRetVal.yaml
LblisConstOperand	LblisConstOperand.yaml
Lblproject'Coln'MyList	Lblproject'Coln'MyList.yaml
Lblproject'Coln'existentialProjection'LParUndsCommUndsCommUndsRParUnds'TYPES'Unds'ExistentialProjection'Unds'TraitDef'Unds'GenericArgs'Unds'TermKind'Coln'genericArgs	Lblproject'Coln'existentialProjection'LParUndsCommUndsCommUndsRParUnds'TYPES'Unds'ExistentialProjection'Unds'TraitDef'Unds'GenericArgs'Unds'TermKind'Coln'genericArgs.yaml
Lblproject'Coln'varDebugInfo'LParUndsCommUndsCommUndsCommUndsCommUndsRParUnds'BODY'Unds'VarDebugInfo'Unds'Symbol'Unds'SourceInfo'Unds'MaybeVarDebugInfoFragment'Unds'VarDebugInfoContents'Unds'MaybeInt'Coln'argumentIndex	Lblproject'Coln'varDebugInfo'LParUndsCommUndsCommUndsCommUndsCommUndsRParUnds'BODY'Unds'VarDebugInfo'Unds'Symbol'Unds'SourceInfo'Unds'MaybeVarDebugInfoFragment'Unds'VarDebugInfoContents'Unds'MaybeInt'Coln'argumentIndex.yaml
LblBytes2Int'LParUndsCommUndsCommUndsRParUnds'BYTES-HOOKED'Unds'Int'Unds'Bytes'Unds'Endianness'Unds'Signedness	LblBytes2Int'LParUndsCommUndsCommUndsRParUnds'BYTES-HOOKED'Unds'Int'Unds'Bytes'Unds'Endianness'Unds'Signedness.yaml
Lbl'Hash'decodeArrayElements'LParUndsCommUndsCommUndsCommUndsRParUnds'RT-DECODING'Unds'List'Unds'Bytes'Unds'TypeInfo'Unds'Int'Unds'List	Lbl'Hash'decodeArrayElements'LParUndsCommUndsCommUndsCommUndsRParUnds'RT-DECODING'Unds'List'Unds'Bytes'Unds'TypeInfo'Unds'Int'Unds'List.yaml
Lblproject'Coln'paramConst'LParUndsCommUndsRParUnds'TYPES'Unds'ParamConst'Unds'MIRInt'Unds'MIRString'Coln'index	Lblproject'Coln'paramConst'LParUndsCommUndsRParUnds'TYPES'Unds'ParamConst'Unds'MIRInt'Unds'MIRString'Coln'index.yaml
LblisSubtypePredicate	LblisSubtypePredicate.yaml
Lbl'Hash'expectUsize'LParUndsRParUnds'RT-DATA'Unds'Int'Unds'Value	Lbl'Hash'expectUsize'LParUndsRParUnds'RT-DATA'Unds'Int'Unds'Value.yaml
LblisMaybeBinderForExistentialTraitRef	LblisMaybeBinderForExistentialTraitRef.yaml
LblisUnwindAction	LblisUnwindAction.yaml
Lblproject'Coln'CallConvention	Lblproject'Coln'CallConvention.yaml
LblcountAllOccurrences'LParUndsCommUndsRParUnds'STRING-COMMON'Unds'Int'Unds'String'Unds'String	LblcountAllOccurrences'LParUndsCommUndsRParUnds'STRING-COMMON'Unds'Int'Unds'String'Unds'String.yaml
Lblproject'Coln'TypeInfo'ColnColn'UnionType'Coln'fields	Lblproject'Coln'TypeInfo'ColnColn'UnionType'Coln'fields.yaml
Lblproject'Coln'GlobalAlloc	Lblproject'Coln'GlobalAlloc.yaml
Lbl'Hash'getBlocks'LParUndsRParUnds'KMIR-CONTROL-FLOW'Unds'List'Unds'Ty	Lbl'Hash'getBlocks'LParUndsRParUnds'KMIR-CONTROL-FLOW'Unds'List'Unds'Ty.yaml
Lblproject'Coln'LocalsCell	Lblproject'Coln'LocalsCell.yaml
LbllookupFunction	LbllookupFunction.yaml
LblisAdtKind	LblisAdtKind.yaml
LblexponentFloat'LParUndsRParUnds'FLOAT'Unds'Int'Unds'Float	LblexponentFloat'LParUndsRParUnds'FLOAT'Unds'Int'Unds'Float.yaml
LblisIntrinsicFunction'LParUndsRParUnds'KMIR-CONTROL-FLOW'Unds'Bool'Unds'MonoItemKind	LblisIntrinsicFunction'LParUndsRParUnds'KMIR-CONTROL-FLOW'Unds'Bool'Unds'MonoItemKind.yaml
LblsubstrString'LParUndsCommUndsCommUndsRParUnds'STRING-COMMON'Unds'String'Unds'String'Unds'Int'Unds'Int	LblsubstrString'LParUndsCommUndsCommUndsRParUnds'STRING-COMMON'Unds'String'Unds'String'Unds'Int'Unds'Int.yaml
LblisTypedLocal	LblisTypedLocal.yaml
LblisUnwindCell	LblisUnwindCell.yaml
Lblproject'Coln'StatementKind'ColnColn'Assign'Coln'place	Lblproject'Coln'StatementKind'ColnColn'Assign'Coln'place.yaml
Lblproject'Coln'StatementKind'ColnColn'FakeRead'Coln'cause	Lblproject'Coln'StatementKind'ColnColn'FakeRead'Coln'cause.yaml
LblisGlobalAllocsMap	LblisGlobalAllocsMap.yaml
LblString2Bool'LParUndsRParUnds'STRING-COMMON'Unds'Bool'Unds'String	LblString2Bool'LParUndsRParUnds'STRING-COMMON'Unds'Bool'Unds'String.yaml
Lblproject'Coln'mirConst'LParUndsCommUndsCommUndsRParUnds'TYPES'Unds'MirConst'Unds'ConstantKind'Unds'Ty'Unds'MirConstId'Coln'ty	Lblproject'Coln'mirConst'LParUndsCommUndsCommUndsRParUnds'TYPES'Unds'MirConst'Unds'ConstantKind'Unds'Ty'Unds'MirConstId'Coln'ty.yaml
LblisPredicatePolarity	LblisPredicatePolarity.yaml
LblisMaybeUserTypeAnnotationIndex	LblisMaybeUserTypeAnnotationIndex.yaml
Lblproject'Coln'Abi'ColnColn'C'Coln'unwind	Lblproject'Coln'Abi'ColnColn'C'Coln'unwind.yaml
Lbl'Unds'inList'Unds'	Lbl'Unds'inList'Unds'.yaml
LblisOperands	LblisOperands.yaml
LblisMaybeAllocation	LblisMaybeAllocation.yaml
Lblproject'Coln'RegionDef	Lblproject'Coln'RegionDef.yaml
Lblproject'Coln'ProvenanceMapEntry	Lblproject'Coln'ProvenanceMapEntry.yaml
LblisCoercePredicate	LblisCoercePredicate.yaml
Lblproject'Coln'StackFrame	Lblproject'Coln'StackFrame.yaml
Lbl'Hash'incrementRef'LParUndsRParUnds'RT-DATA'Unds'Value'Unds'Value	Lbl'Hash'incrementRef'LParUndsRParUnds'RT-DATA'Unds'Value'Unds'Value.yaml
Lblproject'Coln'FakeReadCause	Lblproject'Coln'FakeReadCause.yaml
LblisKmirCell	LblisKmirCell.yaml
LblisMutBorrowKind	LblisMutBorrowKind.yaml
LblList'Coln'set	LblList'Coln'set.yaml
LblisCallerCellOpt	LblisCallerCellOpt.yaml
LblisMonoItemKind	LblisMonoItemKind.yaml
Lblproject'Coln'BorrowKind	Lblproject'Coln'BorrowKind.yaml
LblisRvalue	LblisRvalue.yaml
Lblproject'Coln'PredicateKind	Lblproject'Coln'PredicateKind.yaml
Lblproject'Coln'Mutability	Lblproject'Coln'Mutability.yaml
LbllookupAlloc5	LbllookupAlloc5.yaml
Lblproject'Coln'CurrentFrameCellFragment	Lblproject'Coln'CurrentFrameCellFragment.yaml
Lblproject'Coln'StatementKind'ColnColn'PlaceMention'Coln'place	Lblproject'Coln'StatementKind'ColnColn'PlaceMention'Coln'place.yaml
Lblproject'Coln'BoundRegion	Lblproject'Coln'BoundRegion.yaml
LblisFunctionName	LblisFunctionName.yaml
LbllookupTy0	LbllookupTy0.yaml
Lblproject'Coln'ImplTraitDecls	Lblproject'Coln'ImplTraitDecls.yaml
LblisRegionDef	LblisRegionDef.yaml
Lblproject'Coln'BreakOnFunctionsCellOpt	Lblproject'Coln'BreakOnFunctionsCellOpt.yaml
LblisInt	LblisInt.yaml
Lblproject'Coln'Rvalue	Lblproject'Coln'Rvalue.yaml
LblisDiscriminant	LblisDiscriminant.yaml
Lblproject'Coln'crate'LParUndsCommUndsCommUndsRParUnds'LIB'Unds'Crate'Unds'CrateNum'Unds'Symbol'Unds'MIRBool'Coln'isLocal	Lblproject'Coln'crate'LParUndsCommUndsCommUndsRParUnds'LIB'Unds'Crate'Unds'CrateNum'Unds'Symbol'Unds'MIRBool'Coln'isLocal.yaml
Lbl'Hash'getBlocksAux'LParUndsRParUnds'KMIR-CONTROL-FLOW'Unds'List'Unds'MonoItemKind	Lbl'Hash'getBlocksAux'LParUndsRParUnds'KMIR-CONTROL-FLOW'Unds'List'Unds'MonoItemKind.yaml
Lblproject'Coln'GenericArgs	Lblproject'Coln'GenericArgs.yaml
Lbl'Hash'validDiscriminant'LParUndsCommUndsRParUnds'RT-DATA'Unds'Bool'Unds'Int'Unds'TypeInfo	Lbl'Hash'validDiscriminant'LParUndsCommUndsRParUnds'RT-DATA'Unds'Bool'Unds'Int'Unds'TypeInfo.yaml
Lblproject'Coln'tyConst'LParUndsCommUndsRParUnds'TYPES'Unds'TyConst'Unds'TyConstKind'Unds'TyConstId'Coln'id	Lblproject'Coln'tyConst'LParUndsCommUndsRParUnds'TYPES'Unds'TyConst'Unds'TyConstKind'Unds'TyConstId'Coln'id.yaml
Lblproject'Coln'AssertMessage'ColnColn'BoundsCheck'Coln'index	Lblproject'Coln'AssertMessage'ColnColn'BoundsCheck'Coln'index.yaml
LblisVarDebugInfoContents	LblisVarDebugInfoContents.yaml
LblisMaybeFieldIdx	LblisMaybeFieldIdx.yaml
LblisVariantsShapeSingle	LblisVariantsShapeSingle.yaml
Lblproject'Coln'UserTypeProjection	Lblproject'Coln'UserTypeProjection.yaml
Lblproject'Coln'VariantIdx	Lblproject'Coln'VariantIdx.yaml
Lblproject'Coln'RegionOutlivesPredicate	Lblproject'Coln'RegionOutlivesPredicate.yaml
LblonBool'LParUndsCommUndsCommUndsRParUnds'RT-DATA'Unds'Bool'Unds'BinOp'Unds'Bool'Unds'Bool	LblonBool'LParUndsCommUndsCommUndsRParUnds'RT-DATA'Unds'Bool'Unds'BinOp'Unds'Bool'Unds'Bool.yaml
Lbl'UndsPipe'-'-GT-Unds'	Lbl'UndsPipe'-'-GT-Unds'.yaml
Lblproject'Coln'traitDecl'LParUndsCommUndsCommUndsCommUndsCommUndsCommUndsCommUndsCommUndsCommUndsCommUndsCommUndsRParUnds'TYPES'Unds'TraitDecl'Unds'TraitDef'Unds'Safety'Unds'MIRBool'Unds'MIRBool'Unds'MIRBool'Unds'MIRBool'Unds'MIRBool'Unds'TraitSpecializationKind'Unds'MaybeIdents'Unds'MIRBool'Unds'MIRBool'Coln'isMarker	Lblproject'Coln'traitDecl'LParUndsCommUndsCommUndsCommUndsCommUndsCommUndsCommUndsCommUndsCommUndsCommUndsCommUndsRParUnds'TYPES'Unds'TraitDecl'Unds'TraitDef'Unds'Safety'Unds'MIRBool'Unds'MIRBool'Unds'MIRBool'Unds'MIRBool'Unds'MIRBool'Unds'775.yaml
Lblproject'Coln'AliasKind	Lblproject'Coln'AliasKind.yaml
Lblproject'Coln'RetVal	Lblproject'Coln'RetVal.yaml
Lbl'Unds-LT-Eqls'Map'UndsUnds'MAP'Unds'Bool'Unds'Map'Unds'Map	Lbl'Unds-LT-Eqls'Map'UndsUnds'MAP'Unds'Bool'Unds'Map'Unds'Map.yaml
Lblproject'Coln'existentialProjection'LParUndsCommUndsCommUndsRParUnds'TYPES'Unds'ExistentialProjection'Unds'TraitDef'Unds'GenericArgs'Unds'TermKind'Coln'defId	Lblproject'Coln'existentialProjection'LParUndsCommUndsCommUndsRParUnds'TYPES'Unds'ExistentialProjection'Unds'TraitDef'Unds'GenericArgs'Unds'TermKind'Coln'defId.yaml
LblisUnOp	LblisUnOp.yaml
Lblproject'Coln'TraitDecls	Lblproject'Coln'TraitDecls.yaml
LblisExistentialPredicateBinders	LblisExistentialPredicateBinders.yaml
LblisVarDebugInfo	LblisVarDebugInfo.yaml
LblisBasicBlockIdx	LblisBasicBlockIdx.yaml
Lblproject'Coln'KmirCell	Lblproject'Coln'KmirCell.yaml
LblisList	LblisList.yaml
LbllookupTy5	LbllookupTy5.yaml
Lblproject'Coln'Ident	Lblproject'Coln'Ident.yaml
LblisBinOp	LblisBinOp.yaml
LbllookupTy7	LbllookupTy7.yaml
LblprecisionFloat'LParUndsRParUnds'FLOAT'Unds'Int'Unds'Float	LblprecisionFloat'LParUndsRParUnds'FLOAT'Unds'Int'Unds'Float.yaml
Lblproject'Coln'GenericDef	Lblproject'Coln'GenericDef.yaml
Lblproject'Coln'NumTy	Lblproject'Coln'NumTy.yaml
Lblproject'Coln'passModeIndirect'LParUndsCommUndsCommUndsRParUnds'ABI'Unds'PassMode'Unds'Opaque'Unds'Opaque'Unds'MIRBool'Coln'attrs	Lblproject'Coln'passModeIndirect'LParUndsCommUndsCommUndsRParUnds'ABI'Unds'PassMode'Unds'Opaque'Unds'Opaque'Unds'MIRBool'Coln'attrs.yaml
LblgetFunctionName'LParUndsRParUnds'KMIR-CONTROL-FLOW'Unds'String'Unds'MonoItemKind	LblgetFunctionName'LParUndsRParUnds'KMIR-CONTROL-FLOW'Unds'String'Unds'MonoItemKind.yaml
LbltruncFloat'LParUndsRParUnds'FLOAT'Unds'Float'Unds'Float	LbltruncFloat'LParUndsRParUnds'FLOAT'Unds'Float'Unds'Float.yaml
Lbl'UndsEqlsSlshEqls'Float'UndsUnds'FLOAT'Unds'Bool'Unds'Float'Unds'Float	Lbl'UndsEqlsSlshEqls'Float'UndsUnds'FLOAT'Unds'Bool'Unds'Float'Unds'Float.yaml
LblisInfinite'LParUndsRParUnds'FLOAT'Unds'Bool'Unds'Float	LblisInfinite'LParUndsRParUnds'FLOAT'Unds'Bool'Unds'Float.yaml
LblisBrNamedDef	LblisBrNamedDef.yaml
LblisFnAbi	LblisFnAbi.yaml
Lblproject'Coln'provenanceMapEntry'Coln'allocId	Lblproject'Coln'provenanceMapEntry'Coln'allocId.yaml
LblisGenericParamDefs	LblisGenericParamDefs.yaml
Lbl'Unds-GT-Eqls'Int'Unds'	Lbl'Unds-GT-Eqls'Int'Unds'.yaml
Lblproject'Coln'copyNonOverlapping'LParUndsCommUndsCommUndsRParUnds'BODY'Unds'CopyNonOverlapping'Unds'Operand'Unds'Operand'Unds'Operand'Coln'dst	Lblproject'Coln'copyNonOverlapping'LParUndsCommUndsCommUndsRParUnds'BODY'Unds'CopyNonOverlapping'Unds'Operand'Unds'Operand'Unds'Operand'Coln'dst.yaml
LblisMirConst	LblisMirConst.yaml
Lblproject'Coln'CrateItem	Lblproject'Coln'CrateItem.yaml
LblsinFloat'LParUndsRParUnds'FLOAT'Unds'Float'Unds'Float	LblsinFloat'LParUndsRParUnds'FLOAT'Unds'Float'Unds'Float.yaml
LblisMachineInfo	LblisMachineInfo.yaml
Lbl'Unds'impliesBool'Unds'	Lbl'Unds'impliesBool'Unds'.yaml
LblgetArrayElemTypeInfo'LParUndsRParUnds'RT-TYPES'Unds'TypeInfo'Unds'TypeInfo	LblgetArrayElemTypeInfo'LParUndsRParUnds'RT-TYPES'Unds'TypeInfo'Unds'TypeInfo.yaml
LblisGlobalAllocs	LblisGlobalAllocs.yaml
LblfindChar'LParUndsCommUndsCommUndsRParUnds'STRING-COMMON'Unds'Int'Unds'String'Unds'String'Unds'Int	LblfindChar'LParUndsCommUndsCommUndsRParUnds'STRING-COMMON'Unds'Int'Unds'String'Unds'String'Unds'Int.yaml
LblmaxInt'LParUndsCommUndsRParUnds'INT-COMMON'Unds'Int'Unds'Int'Unds'Int	LblmaxInt'LParUndsCommUndsRParUnds'INT-COMMON'Unds'Int'Unds'Int'Unds'Int.yaml
LbltoKList'LParUndsRParUnds'KMIR-CONTROL-FLOW'Unds'List'Unds'BasicBlocks	LbltoKList'LParUndsRParUnds'KMIR-CONTROL-FLOW'Unds'List'Unds'BasicBlocks.yaml
Lblproject'Coln'Idents	Lblproject'Coln'Idents.yaml
Lbl'Hash'isStaticU8Array'LParUndsRParUnds'RT-DATA'Unds'Bool'Unds'TypeInfo	Lbl'Hash'isStaticU8Array'LParUndsRParUnds'RT-DATA'Unds'Bool'Unds'TypeInfo.yaml
Lblproject'Coln'GlobalAllocsMap	Lblproject'Coln'GlobalAllocsMap.yaml
LblinitKmirCell	LblinitKmirCell.yaml
Lblproject'Coln'StatementKind	Lblproject'Coln'StatementKind.yaml
LblupdateList'LParUndsCommUndsCommUndsRParUnds'LIST'Unds'List'Unds'List'Unds'Int'Unds'List	LblupdateList'LParUndsCommUndsCommUndsRParUnds'LIST'Unds'List'Unds'List'Unds'Int'Unds'List.yaml
LblisAliasTy	LblisAliasTy.yaml
Lblproject'Coln'Int	Lblproject'Coln'Int.yaml
LblisTypeOutlivesPredicate	LblisTypeOutlivesPredicate.yaml
Lblproject'Coln'DebruijinIndex	Lblproject'Coln'DebruijinIndex.yaml
Lblproject'Coln'GenericParamDefs	Lblproject'Coln'GenericParamDefs.yaml
LblisEndian	LblisEndian.yaml
Lblproject'Coln'localDecl'LParUndsCommUndsCommUndsRParUnds'BODY'Unds'LocalDecl'Unds'Ty'Unds'Span'Unds'Mutability'Coln'span	Lblproject'Coln'localDecl'LParUndsCommUndsCommUndsRParUnds'BODY'Unds'LocalDecl'Unds'Ty'Unds'Span'Unds'Mutability'Coln'span.yaml
LblisProvenanceMapEntry	LblisProvenanceMapEntry.yaml
Lblproject'Coln'Statements	Lblproject'Coln'Statements.yaml
Lbl'Unds'dividesInt'UndsUnds'INT-COMMON'Unds'Bool'Unds'Int'Unds'Int	Lbl'Unds'dividesInt'UndsUnds'INT-COMMON'Unds'Bool'Unds'Int'Unds'Int.yaml
LblonShift'LParUndsCommUndsCommUndsCommUndsRParUnds'RT-DATA'Unds'Int'Unds'BinOp'Unds'Int'Unds'Int'Unds'Int	LblonShift'LParUndsCommUndsCommUndsCommUndsRParUnds'RT-DATA'Unds'Int'Unds'BinOp'Unds'Int'Unds'Int'Unds'Int.yaml
Lblproject'ColnHash'execTerminatorCall'LParUndsCommUndsCommUndsCommUndsCommUndsCommUndsRParUnds'KMIR-CONTROL-FLOW'Unds'KItem'Unds'Ty'Unds'MonoItemKind'Unds'Operands'Unds'Place'Unds'MaybeBasicBlockIdx'Unds'UnwindAction'Coln'args	Lblproject'ColnHash'execTerminatorCall'LParUndsCommUndsCommUndsCommUndsCommUndsCommUndsRParUnds'KMIR-CONTROL-FLOW'Unds'KItem'Unds'Ty'Unds'MonoItemKind'Unds'Operands'Unds'Place'Unds'MaybeBasicBlockIdx'Unds'UnwindAction'Coln'args.yaml
Lblproject'Coln'RegionKind	Lblproject'Coln'RegionKind.yaml
LblisTupleType'LParUndsRParUnds'KMIR-CONTROL-FLOW'Unds'Bool'Unds'TypeInfo	LblisTupleType'LParUndsRParUnds'KMIR-CONTROL-FLOW'Unds'Bool'Unds'TypeInfo.yaml
LblisEndianness	LblisEndianness.yaml
Lblproject'Coln'generics'LParUndsCommUndsCommUndsCommUndsCommUndsCommUndsCommUndsRParUnds'TYPES'Unds'Generics'Unds'MaybeGenericDef'Unds'MIRInt'Unds'GenericParamDefs'Unds'GenericDefAndIdxPairs'Unds'MIRBool'Unds'MaybeSpan'Unds'MaybeInt'Coln'hasSelf	Lblproject'Coln'generics'LParUndsCommUndsCommUndsCommUndsCommUndsCommUndsCommUndsRParUnds'TYPES'Unds'Generics'Unds'MaybeGenericDef'Unds'MIRInt'Unds'GenericParamDefs'Unds'GenericDefAndIdxPairs'Unds'MIRBool'Unds'MaybeSpan'Unds'MaybeInt'Coln'h985.yaml
LblreadTyConstInt'LParUndsRParUnds'RT-TYPES'Unds'Int'Unds'TyConstKind	LblreadTyConstInt'LParUndsRParUnds'RT-TYPES'Unds'Int'Unds'TyConstKind.yaml
Lblproject'ColnHash'execTerminatorCall'LParUndsCommUndsCommUndsCommUndsCommUndsCommUndsRParUnds'KMIR-CONTROL-FLOW'Unds'KItem'Unds'Ty'Unds'MonoItemKind'Unds'Operands'Unds'Place'Unds'MaybeBasicBlockIdx'Unds'UnwindAction'Coln'destination	Lblproject'ColnHash'execTerminatorCall'LParUndsCommUndsCommUndsCommUndsCommUndsCommUndsRParUnds'KMIR-CONTROL-FLOW'Unds'KItem'Unds'Ty'Unds'MonoItemKind'Unds'Operands'Unds'Place'Unds'MaybeBasicBlockIdx'Unds'UnwindAction'Coln'destination.yaml
Lbl'Hash'transparentDepth'LParUndsRParUnds'RT-TYPES'Unds'Int'Unds'TypeInfo	Lbl'Hash'transparentDepth'LParUndsRParUnds'RT-TYPES'Unds'Int'Unds'TypeInfo.yaml
Lblproject'Coln'MIRString	Lblproject'Coln'MIRString.yaml
Lbl'Unds-LT--LT-'Int'Unds'	Lbl'Unds-LT--LT-'Int'Unds'.yaml
Lblproject'Coln'Crate	Lblproject'Coln'Crate.yaml
Lblproject'Coln'foreignModule'LParUndsCommUndsRParUnds'TYPES'Unds'ForeignModule'Unds'ForeignModuleDef'Unds'Abi'Coln'defId	Lblproject'Coln'foreignModule'LParUndsCommUndsRParUnds'TYPES'Unds'ForeignModule'Unds'ForeignModuleDef'Unds'Abi'Coln'defId.yaml
Lblproject'Coln'mk'LParUndsRParUnds'TYPES'Unds'VariantsShapeSingle'Unds'VariantIdx'Coln'index	Lblproject'Coln'mk'LParUndsRParUnds'TYPES'Unds'VariantsShapeSingle'Unds'VariantIdx'Coln'index.yaml
LblappendP'LParUndsCommUndsRParUnds'RT-DATA'Unds'ProjectionElems'Unds'ProjectionElems'Unds'ProjectionElems	LblappendP'LParUndsCommUndsRParUnds'RT-DATA'Unds'ProjectionElems'Unds'ProjectionElems'Unds'ProjectionElems.yaml
LblisFakeReadCause	LblisFakeReadCause.yaml
Lblproject'Coln'aliasTy'LParUndsCommUndsRParUnds'TYPES'Unds'AliasTy'Unds'AliasDef'Unds'GenericArgs'Coln'args	Lblproject'Coln'aliasTy'LParUndsCommUndsRParUnds'TYPES'Unds'AliasTy'Unds'AliasDef'Unds'GenericArgs'Coln'args.yaml
LblisFnDef	LblisFnDef.yaml
Lblproject'Coln'Local	Lblproject'Coln'Local.yaml
Lbl'Stop'Bytes'Unds'BYTES-HOOKED'Unds'Bytes	Lbl'Stop'Bytes'Unds'BYTES-HOOKED'Unds'Bytes.yaml
LblgetValue'LParUndsCommUndsRParUnds'RT-DATA'Unds'Value'Unds'List'Unds'Int	LblgetValue'LParUndsCommUndsRParUnds'RT-DATA'Unds'Value'Unds'List'Unds'Int.yaml
Lblproject'Coln'GlobalAllocKind	Lblproject'Coln'GlobalAllocKind.yaml
LblisSwitchTargets	LblisSwitchTargets.yaml
LblisCoroutineKind	LblisCoroutineKind.yaml
Lblproject'Coln'Instance	Lblproject'Coln'Instance.yaml
Lblproject'Coln'FunctionName	Lblproject'Coln'FunctionName.yaml
Lbl'UndsEqlsEqls'String'UndsUnds'STRING-COMMON'Unds'Bool'Unds'String'Unds'String	Lbl'UndsEqlsEqls'String'UndsUnds'STRING-COMMON'Unds'Bool'Unds'String'Unds'String.yaml
LblisInstanceKind	LblisInstanceKind.yaml
Lblproject'Coln'binderForExistentialTraitRef'LParUndsCommUndsRParUnds'ALLOC'Unds'BinderForExistentialTraitRef'Unds'ExistentialTraitRef'Unds'BoundVariableKindList'Coln'boundVars	Lblproject'Coln'binderForExistentialTraitRef'LParUndsCommUndsRParUnds'ALLOC'Unds'BinderForExistentialTraitRef'Unds'ExistentialTraitRef'Unds'BoundVariableKindList'Coln'boundVars.yaml
LblisTermKind	LblisTermKind.yaml
Lblproject'Coln'ArgAbi	Lblproject'Coln'ArgAbi.yaml
LblisKConfigVar	LblisKConfigVar.yaml
Lblproject'Coln'ConstOperand	Lblproject'Coln'ConstOperand.yaml
Lblproject'Coln'ProjectionElem	Lblproject'Coln'ProjectionElem.yaml
Lblproject'Coln'GenericDefAndIdxPair	Lblproject'Coln'GenericDefAndIdxPair.yaml
Lblproject'Coln'tyConst'LParUndsCommUndsRParUnds'TYPES'Unds'TyConst'Unds'TyConstKind'Unds'TyConstId'Coln'kind	Lblproject'Coln'tyConst'LParUndsCommUndsRParUnds'TYPES'Unds'TyConst'Unds'TyConstKind'Unds'TyConstId'Coln'kind.yaml
Lblproject'Coln'rangeInclusiveForVariantIdx'LParUndsCommUndsRParUnds'ABI'Unds'RangeInclusiveForVariantIdx'Unds'VariantIdx'Unds'VariantIdx'Coln'start	Lblproject'Coln'rangeInclusiveForVariantIdx'LParUndsCommUndsRParUnds'ABI'Unds'RangeInclusiveForVariantIdx'Unds'VariantIdx'Unds'VariantIdx'Coln'start.yaml
Lblproject'Coln'MaybeAllocation	Lblproject'Coln'MaybeAllocation.yaml
LblcmpOpBool'LParUndsCommUndsCommUndsRParUnds'RT-DATA'Unds'Bool'Unds'BinOp'Unds'Bool'Unds'Bool	LblcmpOpBool'LParUndsCommUndsCommUndsRParUnds'RT-DATA'Unds'Bool'Unds'BinOp'Unds'Bool'Unds'Bool.yaml
Lblproject'Coln'binderForExistentialTraitRef'LParUndsCommUndsRParUnds'ALLOC'Unds'BinderForExistentialTraitRef'Unds'ExistentialTraitRef'Unds'BoundVariableKindList'Coln'value	Lblproject'Coln'binderForExistentialTraitRef'LParUndsCommUndsRParUnds'ALLOC'Unds'BinderForExistentialTraitRef'Unds'ExistentialTraitRef'Unds'BoundVariableKindList'Coln'value.yaml
LblisMIRBool	LblisMIRBool.yaml
Lblproject'Coln'varDebugInfoFragment'LParUndsCommUndsRParUnds'BODY'Unds'VarDebugInfoFragment'Unds'Ty'Unds'ProjectionElems'Coln'projection	Lblproject'Coln'varDebugInfoFragment'LParUndsCommUndsRParUnds'BODY'Unds'VarDebugInfoFragment'Unds'Ty'Unds'ProjectionElems'Coln'projection.yaml
Lbl'Hash'functionNameMatchesAny'LParUndsCommUndsRParUnds'KMIR-CONTROL-FLOW'Unds'Bool'Unds'String'Unds'Set	Lbl'Hash'functionNameMatchesAny'LParUndsCommUndsRParUnds'KMIR-CONTROL-FLOW'Unds'Bool'Unds'String'Unds'Set.yaml
Lblproject'Coln'LocalDecls	Lblproject'Coln'LocalDecls.yaml
LblBytes2Hex'LParUndsRParUnds'BYTES-HOOKED'Unds'String'Unds'Bytes	LblBytes2Hex'LParUndsRParUnds'BYTES-HOOKED'Unds'String'Unds'Bytes.yaml
Lblproject'Coln'InstanceDef	Lblproject'Coln'InstanceDef.yaml
Lblproject'Coln'SourceInfo	Lblproject'Coln'SourceInfo.yaml
Lblproject'Coln'GeneratedCounterCellOpt	Lblproject'Coln'GeneratedCounterCellOpt.yaml
Lblproject'Coln'genericPredicates'LParUndsCommUndsRParUnds'TYPES'Unds'GenericPredicates'Unds'MaybeTraitDef'Unds'PredicateKindAndSpanPairs'Coln'parent	Lblproject'Coln'genericPredicates'LParUndsCommUndsRParUnds'TYPES'Unds'GenericPredicates'Unds'MaybeTraitDef'Unds'PredicateKindAndSpanPairs'Coln'parent.yaml
Lblproject'Coln'GenericDefAndIdxPairs	Lblproject'Coln'GenericDefAndIdxPairs.yaml
Lblproject'Coln'StackFrame'LParUndsCommUndsCommUndsCommUndsCommUndsRParUnds'KMIR-CONFIGURATION'Unds'StackFrame'Unds'Ty'Unds'Place'Unds'MaybeBasicBlockIdx'Unds'UnwindAction'Unds'List'Coln'target	Lblproject'Coln'StackFrame'LParUndsCommUndsCommUndsCommUndsCommUndsRParUnds'KMIR-CONFIGURATION'Unds'StackFrame'Unds'Ty'Unds'Place'Unds'MaybeBasicBlockIdx'Unds'UnwindAction'Unds'List'Coln'target.yaml
LblrootFloat'LParUndsCommUndsRParUnds'FLOAT'Unds'Float'Unds'Float'Unds'Int	LblrootFloat'LParUndsCommUndsRParUnds'FLOAT'Unds'Float'Unds'Float'Unds'Int.yaml
Lblproject'Coln'MIRInt	Lblproject'Coln'MIRInt.yaml
Lbl'Unds'Map'Unds'	Lbl'Unds'Map'Unds'.yaml
Lbl'Unds'in'Unds'keys'LParUndsRParUnds'MAP'Unds'Bool'Unds'KItem'Unds'Map	Lbl'Unds'in'Unds'keys'LParUndsRParUnds'MAP'Unds'Bool'Unds'KItem'Unds'Map.yaml
Lbl'UndsPipe'Set'UndsUnds'SET'Unds'Set'Unds'Set'Unds'Set	Lbl'UndsPipe'Set'UndsUnds'SET'Unds'Set'Unds'Set'Unds'Set.yaml
Lblproject'Coln'FnAbi	Lblproject'Coln'FnAbi.yaml
LblisComparison'LParUndsRParUnds'RT-DATA'Unds'Bool'Unds'BinOp	LblisComparison'LParUndsRParUnds'RT-DATA'Unds'Bool'Unds'BinOp.yaml
LblisPrimitiveInt	LblisPrimitiveInt.yaml
Lblproject'Coln'CrateNum	Lblproject'Coln'CrateNum.yaml
Lblproject'Coln'TypeInfo	Lblproject'Coln'TypeInfo.yaml
LblString2Bytes'LParUndsRParUnds'BYTES-HOOKED'Unds'Bytes'Unds'String	LblString2Bytes'LParUndsRParUnds'BYTES-HOOKED'Unds'Bytes'Unds'String.yaml
Lblproject'Coln'MaybeInt	Lblproject'Coln'MaybeInt.yaml
Lblproject'Coln'String	Lblproject'Coln'String.yaml
LblisMaybeTy	LblisMaybeTy.yaml
Lblproject'Coln'traitDecl'LParUndsCommUndsCommUndsCommUndsCommUndsCommUndsCommUndsCommUndsCommUndsCommUndsCommUndsRParUnds'TYPES'Unds'TraitDecl'Unds'TraitDef'Unds'Safety'Unds'MIRBool'Unds'MIRBool'Unds'MIRBool'Unds'MIRBool'Unds'MIRBool'Unds'TraitSpecializationKind'Unds'MaybeIdents'Unds'MIRBool'Unds'MIRBool'Coln'denyExplicitImpl	Lblproject'Coln'traitDecl'LParUndsCommUndsCommUndsCommUndsCommUndsCommUndsCommUndsCommUndsCommUndsCommUndsCommUndsRParUnds'TYPES'Unds'TraitDecl'Unds'TraitDef'Unds'Safety'Unds'MIRBool'Unds'MIRBool'Unds'MIRBool'Unds'MIRBool'Unds'MIRBool'Unds'1091.yaml
Lbl'Unds-LT-Eqls'Int'Unds'	Lbl'Unds-LT-Eqls'Int'Unds'.yaml
LblisMaybePromoted	LblisMaybePromoted.yaml
Lblproject'Coln'ForeignItemKind	Lblproject'Coln'ForeignItemKind.yaml
LblisMachineSizes	LblisMachineSizes.yaml
LblisTraitDecl	LblisTraitDecl.yaml
LblexpFloat'LParUndsRParUnds'FLOAT'Unds'Float'Unds'Float	LblexpFloat'LParUndsRParUnds'FLOAT'Unds'Float'Unds'Float.yaml
LblcmpBool'LParUndsCommUndsRParUnds'RT-DATA'Unds'Int'Unds'Bool'Unds'Bool	LblcmpBool'LParUndsCommUndsRParUnds'RT-DATA'Unds'Int'Unds'Bool'Unds'Bool.yaml
LblFloat2Int'LParUndsRParUnds'FLOAT'Unds'Int'Unds'Float	LblFloat2Int'LParUndsRParUnds'FLOAT'Unds'Int'Unds'Float.yaml
LblisMonoItem	LblisMonoItem.yaml
LblSet'Coln'in	LblSet'Coln'in.yaml
LblisTypeMapping	LblisTypeMapping.yaml
LblisGlobalAllocKind	LblisGlobalAllocKind.yaml
Lblproject'Coln'paramTy'LParUndsCommUndsRParUnds'TYPES'Unds'ParamTy'Unds'MIRInt'Unds'MIRString'Coln'name	Lblproject'Coln'paramTy'LParUndsCommUndsRParUnds'TYPES'Unds'ParamTy'Unds'MIRInt'Unds'MIRString'Coln'name.yaml
Lblproject'Coln'CoercePredicate	Lblproject'Coln'CoercePredicate.yaml
Lblproject'Coln'ClosureDef	Lblproject'Coln'ClosureDef.yaml
LblisBoundRegionKind	LblisBoundRegionKind.yaml
LblisRegionKind	LblisRegionKind.yaml
Lbllog2Int'LParUndsRParUnds'INT-COMMON'Unds'Int'Unds'Int	Lbllog2Int'LParUndsRParUnds'INT-COMMON'Unds'Int'Unds'Int.yaml
LblisCoverage	LblisCoverage.yaml
LblisForeignModule	LblisForeignModule.yaml
LblisWrappingRange	LblisWrappingRange.yaml
Lblproject'Coln'TypeInfo'ColnColn'UnionType'Coln'layout	Lblproject'Coln'TypeInfo'ColnColn'UnionType'Coln'layout.yaml
Lblproject'Coln'TypeInfo'ColnColn'StructType'Coln'name	Lblproject'Coln'TypeInfo'ColnColn'StructType'Coln'name.yaml
LblisFieldIdx	LblisFieldIdx.yaml
Lbl'Unds-GT-'String'UndsUnds'STRING-COMMON'Unds'Bool'Unds'String'Unds'String	Lbl'Unds-GT-'String'UndsUnds'STRING-COMMON'Unds'Bool'Unds'String'Unds'String.yaml
Lblproject'Coln'variantDef'LParUndsCommUndsRParUnds'TYPES'Unds'VariantDef'Unds'VariantIdx'Unds'AdtDef'Coln'adtDef	Lblproject'Coln'variantDef'LParUndsCommUndsRParUnds'TYPES'Unds'VariantDef'Unds'VariantIdx'Unds'AdtDef'Coln'adtDef.yaml
LblisImplTraitDecls	LblisImplTraitDecls.yaml
Lblproject'Coln'generics'LParUndsCommUndsCommUndsCommUndsCommUndsCommUndsCommUndsRParUnds'TYPES'Unds'Generics'Unds'MaybeGenericDef'Unds'MIRInt'Unds'GenericParamDefs'Unds'GenericDefAndIdxPairs'Unds'MIRBool'Unds'MaybeSpan'Unds'MaybeInt'Coln'parentCount	Lblproject'Coln'generics'LParUndsCommUndsCommUndsCommUndsCommUndsCommUndsCommUndsRParUnds'TYPES'Unds'Generics'Unds'MaybeGenericDef'Unds'MIRInt'Unds'GenericParamDefs'Unds'GenericDefAndIdxPairs'Unds'MIRBool'Unds'MaybeSpan'Unds'MaybeInt'Coln'p1142.yaml
Lblproject'Coln'CurrentFuncCellOpt	Lblproject'Coln'CurrentFuncCellOpt.yaml
Lblproject'Coln'GeneratedTopCellFragment	Lblproject'Coln'GeneratedTopCellFragment.yaml
LblfindVariantIdxAux	LblfindVariantIdxAux.yaml
Lblproject'Coln'Branch	Lblproject'Coln'Branch.yaml
Lblproject'Coln'Abi'ColnColn'Win64'Coln'unwind	Lblproject'Coln'Abi'ColnColn'Win64'Coln'unwind.yaml
Lblproject'Coln'NullOp	Lblproject'Coln'NullOp.yaml
Lblproject'Coln'ArgAbis	Lblproject'Coln'ArgAbis.yaml
LblreplaceFirst'LParUndsCommUndsCommUndsRParUnds'STRING-COMMON'Unds'String'Unds'String'Unds'String'Unds'String	LblreplaceFirst'LParUndsCommUndsCommUndsRParUnds'STRING-COMMON'Unds'String'Unds'String'Unds'String'Unds'String.yaml
LblisOperand	LblisOperand.yaml
Lblproject'Coln'passModeCast'LParUndsCommUndsRParUnds'ABI'Unds'PassMode'Unds'MIRBool'Unds'Opaque'Coln'cast	Lblproject'Coln'passModeCast'LParUndsCommUndsRParUnds'ABI'Unds'PassMode'Unds'MIRBool'Unds'Opaque'Coln'cast.yaml
LblisCurrentFrameCellOpt	LblisCurrentFrameCellOpt.yaml
Lblproject'Coln'provenanceMapEntry'Coln'offset	Lblproject'Coln'provenanceMapEntry'Coln'offset.yaml
LblisTraitPredicate	LblisTraitPredicate.yaml
Lblproject'Coln'boundRegion'LParUndsCommUndsRParUnds'TYPES'Unds'BoundRegion'Unds'BoundVar'Unds'BoundRegionKind'Coln'kind	Lblproject'Coln'boundRegion'LParUndsCommUndsRParUnds'TYPES'Unds'BoundRegion'Unds'BoundVar'Unds'BoundRegionKind'Coln'kind.yaml
LblisBoundTyKind	LblisBoundTyKind.yaml
Lblproject'Coln'monoItemWrapper'Coln'symbolName	Lblproject'Coln'monoItemWrapper'Coln'symbolName.yaml
LblisArgAbis	LblisArgAbis.yaml
Lblproject'ColnHash'execTerminatorCall'LParUndsCommUndsCommUndsCommUndsCommUndsCommUndsRParUnds'KMIR-CONTROL-FLOW'Unds'KItem'Unds'Ty'Unds'MonoItemKind'Unds'Operands'Unds'Place'Unds'MaybeBasicBlockIdx'Unds'UnwindAction'Coln'func	Lblproject'ColnHash'execTerminatorCall'LParUndsCommUndsCommUndsCommUndsCommUndsCommUndsRParUnds'KMIR-CONTROL-FLOW'Unds'KItem'Unds'Ty'Unds'MonoItemKind'Unds'Operands'Unds'Place'Unds'MaybeBasicBlockIdx'Unds'UnwindAction'Coln'func.yaml
Lbltruncate'LParUndsCommUndsCommUndsRParUnds'RT-NUMBERS'Unds'Int'Unds'Int'Unds'Int'Unds'Signedness	Lbltruncate'LParUndsCommUndsCommUndsRParUnds'RT-NUMBERS'Unds'Int'Unds'Int'Unds'Int'Unds'Signedness.yaml
Lblproject'Coln'PolyFnSig	Lblproject'Coln'PolyFnSig.yaml
LblisExistentialProjection	LblisExistentialProjection.yaml
Lblproject'Coln'KCellOpt	Lblproject'Coln'KCellOpt.yaml
Lblproject'Coln'passModeIndirect'LParUndsCommUndsCommUndsRParUnds'ABI'Unds'PassMode'Unds'Opaque'Unds'Opaque'Unds'MIRBool'Coln'metaAttrs	Lblproject'Coln'passModeIndirect'LParUndsCommUndsCommUndsRParUnds'ABI'Unds'PassMode'Unds'Opaque'Unds'Opaque'Unds'MIRBool'Coln'metaAttrs.yaml
LblisGeneratedCounterCellOpt	LblisGeneratedCounterCellOpt.yaml
LblisInlineAsmOperand	LblisInlineAsmOperand.yaml
Lblproject'Coln'CoroutineDesugaring	Lblproject'Coln'CoroutineDesugaring.yaml
Lblproject'Coln'instance'LParUndsCommUndsRParUnds'MONO'Unds'Instance'Unds'InstanceKind'Unds'InstanceDef'Coln'kind	Lblproject'Coln'instance'LParUndsCommUndsRParUnds'MONO'Unds'Instance'Unds'InstanceKind'Unds'InstanceDef'Coln'kind.yaml
Lblproject'Coln'patternRange'LParUndsCommUndsCommUndsRParUnds'TYPES'Unds'Pattern'Unds'MaybeTyConst'Unds'MaybeTyConst'Unds'MIRBool'Coln'end	Lblproject'Coln'patternRange'LParUndsCommUndsCommUndsRParUnds'TYPES'Unds'Pattern'Unds'MaybeTyConst'Unds'MaybeTyConst'Unds'MIRBool'Coln'end.yaml
Lblproject'Coln'fnAbi'LParUndsCommUndsCommUndsCommUndsCommUndsRParUnds'ABI'Unds'FnAbi'Unds'ArgAbis'Unds'ArgAbi'Unds'MIRInt'Unds'CallConvention'Unds'MIRBool'Coln'args	Lblproject'Coln'fnAbi'LParUndsCommUndsCommUndsCommUndsCommUndsRParUnds'ABI'Unds'FnAbi'Unds'ArgAbis'Unds'ArgAbi'Unds'MIRInt'Unds'CallConvention'Unds'MIRBool'Coln'args.yaml
LblisMetadata	LblisMetadata.yaml
